,Date,State,Positive,Negative,test,pos_rate
1,20200508,AK,1325,1116,2441,0.542810324
57,20200507,AK,1323,1072,2395,0.552400835
113,20200506,AK,1322,1059,2381,0.555228895
169,20200505,AK,1321,1024,2345,0.563326226
225,20200504,AK,1320,982,2302,0.573414422
281,20200503,AK,1310,974,2284,0.573555166
337,20200502,AK,1309,968,2277,0.574879227
393,20200501,AK,1308,822,2130,0.614084507
449,20200430,AK,1296,768,2064,0.627906977
505,20200429,AK,1296,768,2064,0.627906977
561,20200428,AK,1293,650,1943,0.665465775
617,20200427,AK,1281,590,1871,0.684660609
673,20200426,AK,1278,583,1861,0.686727566
729,20200425,AK,1272,566,1838,0.692056583
785,20200424,AK,1272,264,1536,0.828125
841,20200423,AK,1270,259,1529,0.830608241
897,20200422,AK,1268,259,1527,0.830386379
953,20200421,AK,1255,160,1415,0.886925795
1009,20200420,AK,1247,2597,3844,0.324401665
1065,20200419,AK,1235,2582,3817,0.323552528
1121,20200418,AK,1230,2578,3808,0.323004202
1177,20200417,AK,1218,2567,3785,0.321796565
1233,20200416,AK,1210,2456,3666,0.330060011
1289,20200415,AK,1041,2450,3491,0.298195359
1345,20200414,AK,1019,2434,3453,0.295105705
1401,20200413,AK,998,2309,3307,0.301784094
1457,20200412,AK,996,2315,3311,0.300815464
1513,20200411,AK,957,2304,3261,0.293468261
1569,20200410,AK,931,2285,3216,0.28949005
1625,20200409,AK,910,2144,3054,0.297969876
1681,20200408,AK,887,2134,3021,0.293611387
1737,20200407,AK,858,2128,2986,0.287340924
1793,20200406,AK,622,2126,2748,0.226346434
1849,20200405,AK,600,2098,2698,0.222386953
1905,20200404,AK,570,1908,2478,0.230024213
1961,20200403,AK,521,1907,2428,0.214579901
2017,20200402,AK,483,1664,2147,0.224965068
2073,20200401,AK,448,1637,2085,0.214868106
2129,20200331,AK,370,1316,1686,0.21945433
2185,20200330,AK,364,1312,1676,0.217183771
2241,20200329,AK,323,1290,1613,0.200247985
2297,20200328,AK,2101,911,3012,0.697543161
2353,20200327,AK,1903,872,2775,0.685765766
2409,20200326,AK,1752,102,1854,0.944983819
2465,20200325,AK,1482,88,1570,0.943949045
2521,20200324,AK,1300,2679,3979,0.326715255
2577,20200323,AK,866,2648,3514,0.2464428
2633,20200322,AK,866,2648,3514,0.2464428
2689,20200321,AK,457,2392,2849,0.16040716
2745,20200320,AK,371,2254,2625,0.141333333
2801,20200319,AK,1758,1743,3501,0.502142245
2857,20200318,AK,1758,1683,3441,0.510897995
2913,20200317,AK,1049,1453,2502,0.419264588
2969,20200316,AK,3,532,535,0.005607477
3025,20200315,AK,3,532,535,0.005607477
3076,20200314,AK,3,532,535,0.005607477
3127,20200313,AK,3,2072,2075,0.001445783
3178,20200312,AK,2,1785,1787,0.001119194
3229,20200311,AK,2,1785,1787,0.001119194
3279,20200310,AK,2,1052,1054,0.001897533
3329,20200309,AK,2,1052,1054,0.001897533
3379,20200308,AK,2,475,477,0.004192872
3429,20200307,AK,2,315,317,0.006309148
3479,20200306,AK,2,2430,2432,0.000822368
2,20200508,AL,2140,270,2410,0.887966805
58,20200507,AL,2066,199,2265,0.91214128
114,20200506,AL,2051,172,2223,0.922627081
170,20200505,AL,2040,2675,4715,0.432661718
226,20200504,AL,2027,2651,4678,0.433304831
282,20200503,AL,1950,2526,4476,0.435656836
338,20200502,AL,1933,2526,4459,0.43350527
394,20200501,AL,1918,2526,4444,0.431593159
450,20200430,AL,1911,2487,4398,0.434515689
506,20200429,AL,1818,2368,4186,0.434304826
562,20200428,AL,1808,2260,4068,0.444444444
618,20200427,AL,1793,2238,4031,0.444802778
674,20200426,AL,1779,2236,4015,0.443088418
730,20200425,AL,1769,2208,3977,0.444807644
786,20200424,AL,1654,1800,3454,0.478865084
842,20200423,AL,1647,1800,3447,0.477806789
898,20200422,AL,1617,1726,3343,0.483697278
954,20200421,AL,1592,1726,3318,0.479807113
1010,20200420,AL,1570,1678,3248,0.483374384
1066,20200419,AL,1444,1678,3122,0.462524023
1122,20200418,AL,1425,1555,2980,0.478187919
1178,20200417,AL,1413,1437,2850,0.495789474
1234,20200416,AL,1390,1406,2796,0.49713877
1290,20200415,AL,1363,1264,2627,0.518842786
1346,20200414,AL,1177,1250,2427,0.484960857
1402,20200413,AL,1156,1131,2287,0.505465676
1458,20200412,AL,1127,740,1867,0.603642207
1514,20200411,AL,1076,740,1816,0.592511013
1570,20200410,AL,808,740,1548,0.521963824
1626,20200409,AL,777,740,1517,0.512195122
1682,20200408,AL,708,651,1359,0.520971302
1738,20200407,AL,659,355,1014,0.649901381
1794,20200406,AL,274,355,629,0.435612083
1850,20200405,AL,235,235,470,0.5
1906,20200404,AL,175,2573,2748,0.063682678
1962,20200403,AL,143,2438,2581,0.055404882
2018,20200402,AL,82,2306,2388,0.034338358
2074,20200401,AL,29,2127,2156,0.013450835
2130,20200331,AL,2211,2109,4320,0.511805556
2186,20200330,AL,2105,1901,4006,0.525461807
2242,20200329,AL,2077,1621,3698,0.561654949
2298,20200328,AL,1906,1621,3527,0.540402608
2354,20200327,AL,1751,1621,3372,0.519276394
2410,20200326,AL,1680,1315,2995,0.560934891
2466,20200325,AL,1018,886,1904,0.534663866
2522,20200324,AL,861,853,1714,0.502333722
2578,20200323,AL,550,89,639,0.860719875
2634,20200322,AL,455,67,522,0.87164751
2690,20200321,AL,405,1213,1618,0.250309023
2746,20200320,AL,2078,1213,3291,0.631419022
2802,20200319,AL,1895,1213,3108,0.60971686
2858,20200318,AL,1535,1213,2748,0.558588064
2914,20200317,AL,1300,1213,2513,0.517309988
2970,20200316,AL,1001,1213,2214,0.452122855
3026,20200315,AL,371,1213,1584,0.234217172
3077,20200314,AL,1758,1016,2774,0.633741889
3128,20200313,AL,3,219,222,0.013513514
3179,20200312,AL,2,119,121,0.016528926
3230,20200311,AL,2,119,121,0.016528926
3280,20200310,AL,2,2,4,0.5
3330,20200309,AL,2,1,3,0.666666667
3380,20200308,AL,2,1,3,0.666666667
3430,20200307,AL,2,1,3,0.666666667
3,20200508,AR,1150,2149,3299,0.348590482
59,20200507,AR,1139,2025,3164,0.359987358
115,20200506,AR,1135,2011,3146,0.360775588
171,20200505,AR,1124,1939,3063,0.366960496
227,20200504,AR,1120,1931,3051,0.367092756
283,20200503,AR,1115,1850,2965,0.376053963
339,20200502,AR,1105,1832,2937,0.376234253
395,20200501,AR,1095,1793,2888,0.379155125
451,20200430,AR,1087,1769,2856,0.380602241
507,20200429,AR,1077,1708,2785,0.386714542
563,20200428,AR,1066,1548,2614,0.407804132
619,20200427,AR,1051,1543,2594,0.405165767
675,20200426,AR,804,1523,2327,0.345509239
731,20200425,AR,787,1491,2278,0.34547849
787,20200424,AR,769,1415,2184,0.352106227
843,20200423,AR,723,1247,1970,0.367005076
899,20200422,AR,687,1194,1881,0.36523126
955,20200421,AR,679,1123,1802,0.376803552
1011,20200420,AR,265,1099,1364,0.194281525
1067,20200419,AR,228,1028,1256,0.181528662
1123,20200418,AR,220,1027,1247,0.176423416
1179,20200417,AR,205,996,1201,0.170691091
1235,20200416,AR,184,969,1153,0.159583695
1291,20200415,AR,173,936,1109,0.155996393
1347,20200414,AR,154,816,970,0.158762887
1403,20200413,AR,133,807,940,0.141489362
1459,20200412,AR,100,755,855,0.116959064
1515,20200411,AR,79,697,776,0.101804124
1571,20200410,AR,62,593,655,0.094656489
1627,20200409,AR,43,433,476,0.090336134
1683,20200408,AR,4,423,427,0.009367681
1739,20200407,AR,2198,348,2546,0.863315004
1795,20200406,AR,2115,266,2381,0.888282234
1851,20200405,AR,2092,136,2228,0.938958707
1907,20200404,AR,1993,2587,4580,0.435152838
1963,20200403,AR,1970,2484,4454,0.442299057
2019,20200402,AR,1877,2321,4198,0.447117675
2075,20200401,AR,1748,2295,4043,0.432352214
2131,20200331,AR,1695,1914,3609,0.469659185
2187,20200330,AR,1547,1876,3423,0.45194274
2243,20200329,AR,1491,1278,2769,0.538461538
2299,20200328,AR,1468,921,2389,0.614483047
2355,20200327,AR,1332,75,1407,0.946695096
2411,20200326,AR,1268,71,1339,0.946975355
2467,20200325,AR,1014,62,1076,0.942379182
2523,20200324,AR,864,2649,3513,0.245943638
2579,20200323,AR,573,2616,3189,0.179680151
2635,20200322,AR,549,2345,2894,0.189702833
2691,20200321,AR,368,2032,2400,0.153333333
2747,20200320,AR,2205,1505,3710,0.594339623
2803,20200319,AR,1535,1397,2932,0.523533424
2859,20200318,AR,1256,1082,2338,0.537211292
2915,20200317,AR,866,838,1704,0.508215962
2971,20200316,AR,866,447,1313,0.659558264
3027,20200315,AR,525,185,710,0.73943662
3078,20200314,AR,371,2203,2574,0.144133644
3129,20200313,AR,2128,1344,3472,0.612903226
3180,20200312,AR,1758,1086,2844,0.61814346
3231,20200311,AR,2,315,317,0.006309148
3281,20200310,AR,2,315,317,0.006309148
3331,20200309,AR,2,315,317,0.006309148
3381,20200308,AR,2,2089,2091,0.00095648
3431,20200307,AR,2,2089,2091,0.00095648
3480,20200306,AR,2,2089,2091,0.00095648
4,20200508,AS,2,2512,2514,0.000795545
60,20200507,AS,2,2512,2514,0.000795545
116,20200506,AS,2,2512,2514,0.000795545
172,20200505,AS,2,2512,2514,0.000795545
228,20200504,AS,2,2512,2514,0.000795545
284,20200503,AS,2,2034,2036,0.000982318
340,20200502,AS,2,2034,2036,0.000982318
396,20200501,AS,2,2034,2036,0.000982318
452,20200430,AS,2,1274,1276,0.001567398
508,20200429,AS,2,1274,1276,0.001567398
564,20200428,AS,2,1274,1276,0.001567398
620,20200427,AS,2,1274,1276,0.001567398
676,20200426,AS,2,1274,1276,0.001567398
732,20200425,AS,2,1274,1276,0.001567398
788,20200424,AS,2,1274,1276,0.001567398
844,20200423,AS,2,1274,1276,0.001567398
900,20200422,AS,2,1274,1276,0.001567398
956,20200421,AS,2,1274,1276,0.001567398
1012,20200420,AS,2,1274,1276,0.001567398
1068,20200419,AS,2,1274,1276,0.001567398
1124,20200418,AS,2,1274,1276,0.001567398
1180,20200417,AS,2,1274,1276,0.001567398
1236,20200416,AS,2,1274,1276,0.001567398
1292,20200415,AS,2,1274,1276,0.001567398
1348,20200414,AS,2,1274,1276,0.001567398
1404,20200413,AS,2,1274,1276,0.001567398
1460,20200412,AS,2,1274,1276,0.001567398
1516,20200411,AS,2,1274,1276,0.001567398
1572,20200410,AS,2,1274,1276,0.001567398
1628,20200409,AS,2,1274,1276,0.001567398
1684,20200408,AS,2,1274,1276,0.001567398
1740,20200407,AS,2,1274,1276,0.001567398
1796,20200406,AS,2,1274,1276,0.001567398
1852,20200405,AS,2,1274,1276,0.001567398
1908,20200404,AS,2,1274,1276,0.001567398
1964,20200403,AS,2,1274,1276,0.001567398
2020,20200402,AS,2,1274,1276,0.001567398
2076,20200401,AS,2,1274,1276,0.001567398
2132,20200331,AS,2,1274,1276,0.001567398
2188,20200330,AS,1,1,2,0.5
2244,20200329,AS,1,1,2,0.5
2300,20200328,AS,1,1,2,0.5
2356,20200327,AS,1,1,2,0.5
2412,20200326,AS,1,1,2,0.5
2468,20200325,AS,1,1,2,0.5
2524,20200324,AS,1,1,2,0.5
2580,20200323,AS,1,1,2,0.5
2636,20200322,AS,1,1,2,0.5
2692,20200321,AS,1,1,2,0.5
2748,20200320,AS,1,1,2,0.5
2804,20200319,AS,1,1,2,0.5
2860,20200318,AS,1,1,2,0.5
2916,20200317,AS,1,1,2,0.5
2972,20200316,AS,1,1,2,0.5
5,20200508,AZ,306,217,523,0.585086042
61,20200507,AZ,2167,175,2342,0.925277541
117,20200506,AZ,2160,2507,4667,0.462824084
173,20200505,AZ,2143,2421,4564,0.469544259
229,20200504,AZ,2070,2396,4466,0.463502015
285,20200503,AZ,2054,2351,4405,0.466288309
341,20200502,AZ,2041,2266,4307,0.473879731
397,20200501,AZ,1963,2226,4189,0.46860826
453,20200430,AZ,1943,2192,4135,0.469891173
509,20200429,AZ,1921,2162,4083,0.470487387
565,20200428,AZ,1827,2152,3979,0.459160593
621,20200427,AZ,1810,2083,3893,0.464937067
677,20200426,AZ,1799,2062,3861,0.465941466
733,20200425,AZ,1780,2021,3801,0.468297816
789,20200424,AZ,1759,1992,3751,0.468941616
845,20200423,AZ,1646,1960,3606,0.456461453
901,20200422,AZ,1615,1940,3555,0.454289733
957,20200421,AZ,1595,1856,3451,0.462184874
1013,20200420,AZ,1575,1849,3424,0.459988318
1069,20200419,AZ,1457,1829,3286,0.443396226
1125,20200418,AZ,1433,1792,3225,0.444341085
1181,20200417,AZ,1409,1760,3169,0.444619754
1237,20200416,AZ,1379,1723,3102,0.444551902
1293,20200415,AZ,1188,1692,2880,0.4125
1349,20200414,AZ,1167,1671,2838,0.411205074
1405,20200413,AZ,1152,1599,2751,0.418756816
1461,20200412,AZ,1130,1573,2703,0.418054014
1517,20200411,AZ,1109,1537,2646,0.419123205
1573,20200410,AZ,1067,1468,2535,0.420907298
1629,20200409,AZ,1052,1459,2511,0.418956591
1685,20200408,AZ,766,1391,2157,0.355122856
1741,20200407,AZ,742,1363,2105,0.352494062
1797,20200406,AZ,722,1348,2070,0.348792271
1853,20200405,AZ,686,1121,1807,0.379634754
1909,20200404,AZ,636,1121,1757,0.361980649
1965,20200403,AZ,226,1038,1264,0.178797468
2021,20200402,AZ,181,970,1151,0.157254561
2077,20200401,AZ,136,814,950,0.143157895
2133,20200331,AZ,102,743,845,0.120710059
2189,20200330,AZ,56,570,626,0.089456869
2245,20200329,AZ,2182,360,2542,0.858379229
2301,20200328,AZ,2114,2302,4416,0.478713768
2357,20200327,AZ,1989,2302,4291,0.463528315
2413,20200326,AZ,1739,1481,3220,0.540062112
2469,20200325,AZ,1527,1423,2950,0.517627119
2525,20200324,AZ,1298,1400,2698,0.481097109
2581,20200323,AZ,978,1375,2353,0.415639609
2637,20200322,AZ,517,1238,1755,0.294586895
2693,20200321,AZ,326,1108,1434,0.227336123
2749,20200320,AZ,1880,1003,2883,0.652098508
2805,20200319,AZ,1508,732,2240,0.673214286
2861,20200318,AZ,1001,545,1546,0.647477361
2917,20200317,AZ,813,528,1341,0.606263982
2973,20200316,AZ,577,379,956,0.603556485
3028,20200315,AZ,371,363,734,0.505449591
3079,20200314,AZ,371,363,734,0.505449591
3130,20200313,AZ,2128,2643,4771,0.446028086
3181,20200312,AZ,2128,2506,4634,0.459214502
3232,20200311,AZ,2128,2072,4200,0.506666667
3282,20200310,AZ,1758,1937,3695,0.475778078
3332,20200309,AZ,1567,1746,3313,0.47298521
3382,20200308,AZ,1567,1746,3313,0.47298521
3432,20200307,AZ,1567,1746,3313,0.47298521
3481,20200306,AZ,1049,1430,2479,0.423154498
3515,20200305,AZ,628,1213,1841,0.341118957
3539,20200304,AZ,628,1182,1810,0.346961326
6,20200508,CA,1858,2504,4362,0.425951398
62,20200507,CA,1836,2423,4259,0.43108711
118,20200506,CA,1745,2391,4136,0.421905222
174,20200505,CA,1727,2359,4086,0.422662751
230,20200504,CA,1710,2272,3982,0.429432446
286,20200503,CA,1701,2228,3929,0.432934589
342,20200502,CA,1690,2189,3879,0.435679299
398,20200501,CA,1673,2157,3830,0.436814621
454,20200430,CA,1554,2056,3610,0.430470914
510,20200429,CA,1537,2017,3554,0.432470456
566,20200428,CA,1522,1981,3503,0.434484727
622,20200427,CA,1499,1936,3435,0.436390102
678,20200426,CA,1484,1845,3329,0.445779513
734,20200425,CA,1472,1804,3276,0.449328449
790,20200424,CA,1338,1781,3119,0.428983649
846,20200423,CA,1315,1765,3080,0.426948052
902,20200422,CA,1290,1719,3009,0.428713858
958,20200421,CA,1260,1177,2437,0.517029134
1014,20200420,CA,1208,1148,2356,0.512733447
1070,20200419,CA,1196,1142,2338,0.511548332
1126,20200418,CA,1013,1076,2089,0.484921015
1182,20200417,CA,990,1046,2036,0.486247544
1238,20200416,CA,965,1042,2007,0.48081714
1294,20200415,CA,917,829,1746,0.525200458
1350,20200414,CA,898,737,1635,0.549235474
1406,20200413,CA,872,683,1555,0.560771704
1462,20200412,CA,851,683,1534,0.554758801
1518,20200411,CA,612,600,1212,0.504950495
1574,20200410,CA,612,538,1150,0.532173913
1630,20200409,CA,583,536,1119,0.521000894
1686,20200408,CA,543,387,930,0.583870968
1742,20200407,CA,510,291,801,0.63670412
1798,20200406,CA,464,186,650,0.713846154
1854,20200405,CA,423,186,609,0.694581281
1910,20200404,CA,372,179,551,0.675136116
1966,20200403,CA,312,1098,1410,0.221276596
2022,20200402,CA,2137,1067,3204,0.666978777
2078,20200401,CA,2031,993,3024,0.671626984
2134,20200331,CA,1937,993,2930,0.66109215
2190,20200330,CA,1790,943,2733,0.654957922
2246,20200329,CA,1639,943,2582,0.634779241
2302,20200328,CA,1423,943,2366,0.601437025
2358,20200327,CA,1178,699,1877,0.62759723
2414,20200326,CA,1050,699,1749,0.600343053
2470,20200325,CA,702,591,1293,0.542923434
2526,20200324,CA,655,419,1074,0.609869646
2582,20200323,CA,216,342,558,0.387096774
2638,20200322,CA,166,237,403,0.41191067
2694,20200321,CA,99,233,332,0.298192771
2750,20200320,CA,22,138,160,0.1375
2806,20200319,CA,2187,2478,4665,0.468810289
2862,20200318,CA,1849,2324,4173,0.443086509
2918,20200317,CA,1558,2324,3882,0.401339516
2974,20200316,CA,1268,2324,3592,0.353006682
3029,20200315,CA,1041,2623,3664,0.284115721
3080,20200314,CA,952,2623,3575,0.266293706
3131,20200313,CA,831,2623,3454,0.24059062
3182,20200312,CA,831,2623,3454,0.24059062
3233,20200311,CA,521,2623,3144,0.165712468
3283,20200310,CA,448,2270,2718,0.164827079
3333,20200309,CA,364,2270,2634,0.138192863
3383,20200308,CA,2117,1803,3920,0.54005102
3433,20200307,CA,1903,1803,3706,0.513491635
3482,20200306,CA,1834,1803,3637,0.504261754
3516,20200305,CA,1699,1803,3502,0.485151342
3540,20200304,CA,1699,1803,3502,0.485151342
7,20200508,CO,590,2389,2979,0.198053038
63,20200507,CO,566,2367,2933,0.192976475
119,20200506,CO,558,2248,2806,0.198859587
175,20200505,CO,542,2243,2785,0.194614004
231,20200504,CO,537,2222,2759,0.194635738
287,20200503,CO,527,2185,2712,0.194321534
343,20200502,CO,508,2160,2668,0.190404798
399,20200501,CO,499,2038,2537,0.196689003
455,20200430,CO,475,2024,2499,0.19007603
511,20200429,CO,472,1993,2465,0.19148073
567,20200428,CO,438,1955,2393,0.183033849
623,20200427,CO,424,1854,2278,0.186128183
679,20200426,CO,395,1799,2194,0.180036463
735,20200425,CO,378,1756,2134,0.177132146
791,20200424,CO,341,1687,2028,0.168145957
847,20200423,CO,317,1603,1920,0.165104167
903,20200422,CO,304,1569,1873,0.16230646
959,20200421,CO,289,1541,1830,0.157923497
1015,20200420,CO,2161,1522,3683,0.586749932
1071,20200419,CO,2147,1489,3636,0.590484048
1127,20200418,CO,2129,1461,3590,0.593036212
1183,20200417,CO,2057,1432,3489,0.589567211
1239,20200416,CO,2039,1408,3447,0.591528866
1295,20200415,CO,1962,1384,3346,0.586371787
1351,20200414,CO,1946,1377,3323,0.585615408
1407,20200413,CO,1945,1263,3208,0.606296758
1463,20200412,CO,1823,1204,3027,0.602246449
1519,20200411,CO,1796,1154,2950,0.608813559
1575,20200410,CO,1796,1154,2950,0.608813559
1631,20200409,CO,1634,1062,2696,0.606083086
1687,20200408,CO,1611,1034,2645,0.609073724
1743,20200407,CO,1588,992,2580,0.615503876
1799,20200406,CO,1459,948,2407,0.606148733
1855,20200405,CO,1416,804,2220,0.637837838
1911,20200404,CO,1372,715,2087,0.657402971
1967,20200403,CO,1154,648,1802,0.640399556
2023,20200402,CO,1101,562,1663,0.662056524
2079,20200401,CO,807,436,1243,0.64923572
2135,20200331,CO,749,352,1101,0.680290645
2191,20200330,CO,749,352,1101,0.680290645
2247,20200329,CO,648,232,880,0.736363636
2303,20200328,CO,217,2608,2825,0.076814159
2359,20200327,CO,142,2470,2612,0.054364472
2415,20200326,CO,33,2143,2176,0.015165441
2471,20200325,CO,2177,2131,4308,0.505338904
2527,20200324,CO,1980,1889,3869,0.511760145
2583,20200323,CO,1754,1661,3415,0.513616398
2639,20200322,CO,1548,1614,3162,0.489563567
2695,20200321,CO,1307,1295,2602,0.502305919
2751,20200320,CO,998,900,1898,0.525816649
2807,20200319,CO,862,854,1716,0.502331002
2863,20200318,CO,598,84,682,0.876832845
2919,20200317,CO,544,10,554,0.981949458
2975,20200316,CO,445,2182,2627,0.169394747
3030,20200315,CO,445,2182,2627,0.169394747
3081,20200314,CO,322,2170,2492,0.129213483
3132,20200313,CO,1978,1964,3942,0.501775748
3183,20200312,CO,1521,1272,2793,0.544575725
3234,20200311,CO,1001,1143,2144,0.466884328
3284,20200310,CO,371,528,899,0.412680756
3334,20200309,CO,2128,452,2580,0.824806202
3384,20200308,CO,2025,193,2218,0.912984671
3434,20200307,CO,2025,2001,4026,0.502980626
3483,20200306,CO,628,1785,2413,0.260256942
3517,20200305,CO,2,793,795,0.002515723
8,20200508,CT,1242,2552,3794,0.327358988
64,20200507,CT,1226,2523,3749,0.327020539
120,20200506,CT,1209,2489,3698,0.326933478
176,20200505,CT,1201,2413,3614,0.33231876
232,20200504,CT,1029,2365,3394,0.303182086
288,20200503,CT,1029,2365,3394,0.303182086
344,20200502,CT,1011,2341,3352,0.301610979
400,20200501,CT,1011,2341,3352,0.301610979
456,20200430,CT,993,2264,3257,0.304881793
512,20200429,CT,971,2242,3213,0.302209773
568,20200428,CT,966,2221,3187,0.30310637
624,20200427,CT,938,1990,2928,0.320355191
680,20200426,CT,938,1990,2928,0.320355191
736,20200425,CT,920,1967,2887,0.3186699
792,20200424,CT,904,1918,2822,0.320340184
848,20200423,CT,894,1836,2730,0.327472527
904,20200422,CT,873,1808,2681,0.325624767
960,20200421,CT,818,1738,2556,0.320031299
1016,20200420,CT,615,1714,2329,0.264061829
1072,20200419,CT,561,1676,2237,0.250782298
1128,20200418,CT,540,1574,2114,0.255439924
1184,20200417,CT,540,1574,2114,0.255439924
1240,20200416,CT,511,1539,2050,0.249268293
1296,20200415,CT,474,1495,1969,0.240731336
1352,20200414,CT,441,1393,1834,0.240458015
1408,20200413,CT,420,1365,1785,0.235294118
1464,20200412,CT,373,1248,1621,0.230104874
1520,20200411,CT,346,1222,1568,0.220663265
1576,20200410,CT,308,1136,1444,0.213296399
1632,20200409,CT,2162,1065,3227,0.66997211
1688,20200408,CT,1952,978,2930,0.666211604
1744,20200407,CT,1952,978,2930,0.666211604
1800,20200406,CT,1824,817,2641,0.690647482
1856,20200405,CT,1637,705,2342,0.698975235
1912,20200404,CT,1598,651,2249,0.710538017
1968,20200403,CT,1454,552,2006,0.724825523
2024,20200402,CT,1170,499,1669,0.701018574
2080,20200401,CT,1134,403,1537,0.737800911
2136,20200331,CT,1070,402,1472,0.726902174
2192,20200330,CT,741,316,1057,0.701040681
2248,20200329,CT,281,2604,2885,0.097400347
2304,20200328,CT,103,2281,2384,0.043204698
2360,20200327,CT,103,2281,2384,0.043204698
2416,20200326,CT,6,1899,1905,0.003149606
2472,20200325,CT,2115,1866,3981,0.531273549
2528,20200324,CT,1854,1647,3501,0.529562982
2584,20200323,CT,1480,1615,3095,0.47819063
2640,20200322,CT,885,917,1802,0.491120977
2696,20200321,CT,623,853,1476,0.422086721
2752,20200320,CT,623,2156,2779,0.22418136
2808,20200319,CT,2205,2156,4361,0.505617978
2864,20200318,CT,1895,379,2274,0.833333333
2920,20200317,CT,1470,379,1849,0.795024337
2976,20200316,CT,961,379,1340,0.717164179
3031,20200315,CT,813,379,1192,0.68204698
3082,20200314,CT,334,379,713,0.468443198
3133,20200313,CT,1758,2680,4438,0.39612438
3184,20200312,CT,1758,2557,4315,0.407415991
3235,20200311,CT,1049,2338,3387,0.309713611
3285,20200310,CT,628,1984,2612,0.24042879
3335,20200309,CT,3,1785,1788,0.001677852
3385,20200308,CT,3,1243,1246,0.002407705
3435,20200307,CT,2,1,3,0.666666667
9,20200508,DC,1661,975,2636,0.630121396
65,20200507,DC,1633,933,2566,0.636399065
121,20200506,DC,1616,810,2426,0.666117065
177,20200505,DC,1604,794,2398,0.668890742
233,20200504,DC,1587,764,2351,0.675031901
289,20200503,DC,1568,744,2312,0.678200692
345,20200502,DC,1440,693,2133,0.675105485
401,20200501,DC,1426,638,2064,0.690891473
457,20200430,DC,1387,580,1967,0.705134723
513,20200429,DC,1362,553,1915,0.711227154
569,20200428,DC,1191,519,1710,0.696491228
625,20200427,DC,1179,500,1679,0.702203693
681,20200426,DC,1173,488,1661,0.706201084
737,20200425,DC,1151,425,1576,0.730329949
793,20200424,DC,1128,399,1527,0.73870334
849,20200423,DC,1104,343,1447,0.762957844
905,20200422,DC,1080,333,1413,0.76433121
961,20200421,DC,1065,260,1325,0.803773585
1017,20200420,DC,802,228,1030,0.778640777
1073,20200419,DC,782,164,946,0.826638478
1129,20200418,DC,758,149,907,0.835722161
1185,20200417,DC,726,127,853,0.851113716
1241,20200416,DC,700,2596,3296,0.212378641
1297,20200415,DC,671,2576,3247,0.206652294
1353,20200414,DC,646,2571,3217,0.200808206
1409,20200413,DC,271,2483,2754,0.098402324
1465,20200412,DC,256,2477,2733,0.09366996
1521,20200411,DC,227,2443,2670,0.085018727
1577,20200410,DC,194,2312,2506,0.077414206
1633,20200409,DC,161,2286,2447,0.065794851
1689,20200408,DC,145,2135,2280,0.063596491
1745,20200407,DC,75,2123,2198,0.034121929
1801,20200406,DC,36,2114,2150,0.016744186
1857,20200405,DC,2221,1906,4127,0.538163315
1913,20200404,DC,2172,1892,4064,0.534448819
1969,20200403,DC,2003,1659,3662,0.546968869
2025,20200402,DC,1882,1635,3517,0.535115155
2081,20200401,DC,1750,1293,3043,0.575090371
2137,20200331,DC,1564,1293,2857,0.547427371
2193,20200330,DC,1465,901,2366,0.619188504
2249,20200329,DC,1279,885,2164,0.59103512
2305,20200328,DC,1213,861,2074,0.584860174
2361,20200327,DC,979,110,1089,0.898989899
2417,20200326,DC,908,85,993,0.914400806
2473,20200325,DC,598,60,658,0.90881459
2529,20200324,DC,454,24,478,0.949790795
2585,20200323,DC,366,14,380,0.963157895
2641,20200322,DC,2210,2659,4869,0.45389197
2697,20200321,DC,2009,1935,3944,0.509381339
2753,20200320,DC,1973,1932,3905,0.50524968
2809,20200319,DC,1336,602,1938,0.689370485
2865,20200318,DC,1219,466,1685,0.723442136
2921,20200317,DC,866,193,1059,0.817752597
2977,20200316,DC,553,2661,3214,0.172059739
3032,20200315,DC,525,2424,2949,0.17802645
3083,20200314,DC,283,1846,2129,0.132926256
3134,20200313,DC,283,927,1210,0.233884298
3185,20200312,DC,283,927,1210,0.233884298
3236,20200311,DC,1567,927,2494,0.628307939
3286,20200310,DC,1567,688,2255,0.694900222
3336,20200309,DC,3,475,478,0.006276151
3386,20200308,DC,3,119,122,0.024590164
3436,20200307,DC,2,2430,2432,0.000822368
3484,20200306,DC,2,2430,2432,0.000822368
3518,20200305,DC,2,2089,2091,0.00095648
10,20200508,DE,1767,1022,2789,0.633560416
66,20200507,DE,1666,983,2649,0.628916572
122,20200506,DE,1647,945,2592,0.635416667
178,20200505,DE,1609,802,2411,0.667357943
234,20200504,DE,1600,770,2370,0.675105485
290,20200503,DE,1590,759,2349,0.67688378
346,20200502,DE,1572,741,2313,0.679636835
402,20200501,DE,1456,708,2164,0.672828096
458,20200430,DE,1434,691,2125,0.674823529
514,20200429,DE,1425,655,2080,0.685096154
570,20200428,DE,1417,645,2062,0.687196896
626,20200427,DE,1371,567,1938,0.707430341
682,20200426,DE,1354,559,1913,0.707788813
738,20200425,DE,1136,482,1618,0.70210136
794,20200424,DE,1117,438,1555,0.718327974
850,20200423,DE,1091,426,1517,0.719182597
906,20200422,DE,1079,417,1496,0.721256684
962,20200421,DE,803,431,1234,0.650729335
1018,20200420,DE,770,431,1201,0.64113239
1074,20200419,DE,734,328,1062,0.691148776
1130,20200418,DE,696,254,950,0.732631579
1186,20200417,DE,696,254,950,0.732631579
1242,20200416,DE,652,234,886,0.735891648
1298,20200415,DE,634,226,860,0.737209302
1354,20200414,DE,224,145,369,0.60704607
1410,20200413,DE,186,128,314,0.592356688
1466,20200412,DE,153,2586,2739,0.055859803
1522,20200411,DE,153,2586,2739,0.055859803
1578,20200410,DE,111,137,248,0.447580645
1634,20200409,DE,73,2467,2540,0.028740157
1690,20200408,DE,2189,2310,4499,0.486552567
1746,20200407,DE,2189,2310,4499,0.486552567
1802,20200406,DE,1892,2111,4003,0.472645516
1858,20200405,DE,1892,2111,4003,0.472645516
1914,20200404,DE,1756,1909,3665,0.479126876
1970,20200403,DE,1527,1668,3195,0.477934272
2026,20200402,DE,1344,1643,2987,0.449949782
2082,20200401,DE,1310,1612,2922,0.448323066
2138,20200331,DE,1235,1323,2558,0.482799062
2194,20200330,DE,977,863,1840,0.530978261
2250,20200329,DE,909,1514,2423,0.375154767
2306,20200328,DE,860,1514,2374,0.362257793
2362,20200327,DE,547,1514,2061,0.265405143
2418,20200326,DE,442,1514,1956,0.22597137
2474,20200325,DE,365,1514,1879,0.194252262
2530,20200324,DE,2176,1514,3690,0.589701897
2586,20200323,DE,1895,1514,3409,0.55588149
2642,20200322,DE,1725,1514,3239,0.532571781
2698,20200321,DE,1521,1514,3035,0.501153213
2754,20200320,DE,1327,1514,2841,0.467089053
2810,20200319,DE,1193,1514,2707,0.440709272
2866,20200318,DE,936,1514,2450,0.382040816
2922,20200317,DE,525,1514,2039,0.257479156
2978,20200316,DE,2025,1514,3539,0.572195535
3033,20200315,DE,1758,1514,3272,0.537286064
3084,20200314,DE,1758,1514,3272,0.537286064
3135,20200313,DE,1349,1344,2693,0.500928333
3186,20200312,DE,1349,1052,2401,0.561849229
3237,20200311,DE,3,688,691,0.004341534
3287,20200310,DE,2,688,690,0.002898551
3337,20200309,DE,2,551,553,0.003616637
3387,20200308,DE,2,119,121,0.016528926
3437,20200307,DE,2,119,121,0.016528926
3485,20200306,DE,2,119,121,0.016528926
11,20200508,FL,1337,1822,3159,0.423235201
67,20200507,FL,1331,1780,3111,0.427836708
123,20200506,FL,1328,1763,3091,0.429634423
179,20200505,FL,1316,1718,3034,0.433750824
235,20200504,FL,1304,1684,2988,0.436412316
291,20200503,FL,1301,1607,2908,0.44738652
347,20200502,FL,1291,1578,2869,0.449982572
403,20200501,FL,1277,1532,2809,0.454610182
459,20200430,FL,1262,1483,2745,0.459744991
515,20200429,FL,1258,1478,2736,0.459795322
571,20200428,FL,1244,1454,2698,0.461082283
627,20200427,FL,1239,1425,2664,0.46509009
683,20200426,FL,1224,1401,2625,0.466285714
739,20200425,FL,1206,1370,2576,0.468167702
795,20200424,FL,1195,1241,2436,0.490558292
851,20200423,FL,1012,1179,2191,0.461889548
907,20200422,FL,1008,1169,2177,0.463022508
963,20200421,FL,989,1115,2104,0.470057034
1019,20200420,FL,970,1085,2055,0.472019465
1075,20200419,FL,949,1075,2024,0.468873518
1131,20200418,FL,938,1043,1981,0.473498233
1187,20200417,FL,915,1002,1917,0.477308294
1243,20200416,FL,882,836,1718,0.51338766
1299,20200415,FL,875,825,1700,0.514705882
1355,20200414,FL,843,780,1623,0.519408503
1411,20200413,FL,823,734,1557,0.528580604
1467,20200412,FL,610,671,1281,0.476190476
1523,20200411,FL,584,606,1190,0.490756303
1579,20200410,FL,560,537,1097,0.510483136
1635,20200409,FL,531,460,991,0.535822402
1691,20200408,FL,500,388,888,0.563063063
1747,20200407,FL,473,375,848,0.557783019
1803,20200406,FL,419,218,637,0.657770801
1859,20200405,FL,376,176,552,0.68115942
1915,20200404,FL,337,2615,2952,0.114159892
1971,20200403,FL,2154,2508,4662,0.462033462
2027,20200402,FL,2026,2262,4288,0.472481343
2083,20200401,FL,1829,2079,3908,0.46801433
2139,20200331,FL,1783,1986,3769,0.47306978
2195,20200330,FL,1619,1833,3452,0.469003476
2251,20200329,FL,1381,1584,2965,0.465767285
2307,20200328,FL,1160,1494,2654,0.437076112
2363,20200327,FL,776,1218,1994,0.389167503
2419,20200326,FL,702,1066,1768,0.397058824
2475,20200325,FL,200,565,765,0.261437908
2531,20200324,FL,135,406,541,0.249537893
2587,20200323,FL,62,224,286,0.216783217
2643,20200322,FL,2092,2325,4417,0.473624632
2699,20200321,FL,1884,2120,4004,0.470529471
2755,20200320,FL,1694,108,1802,0.940066593
2811,20200319,FL,1342,72,1414,0.949080622
2867,20200318,FL,1230,33,1263,0.973871734
2923,20200317,FL,601,2646,3247,0.185093933
2979,20200316,FL,481,2253,2734,0.175932699
3034,20200315,FL,366,2241,2607,0.140391254
3085,20200314,FL,2009,1824,3833,0.524132533
3136,20200313,FL,1670,1824,3494,0.477962221
3187,20200312,FL,1236,1368,2604,0.474654378
3238,20200311,FL,1001,1368,2369,0.422541157
3288,20200310,FL,605,1044,1649,0.366889024
3338,20200309,FL,577,524,1101,0.524069028
3388,20200308,FL,553,305,858,0.644522145
3438,20200307,FL,457,167,624,0.732371795
3486,20200306,FL,2128,2001,4129,0.515379026
3519,20200305,FL,2128,1376,3504,0.607305936
3541,20200304,FL,628,1086,1714,0.366394399
12,20200508,GA,1238,832,2070,0.598067633
68,20200507,GA,1222,787,2009,0.608262817
124,20200506,GA,1203,727,1930,0.623316062
180,20200505,GA,1035,725,1760,0.588068182
236,20200504,GA,1031,604,1635,0.63058104
292,20200503,GA,1009,540,1549,0.651387992
348,20200502,GA,1007,540,1547,0.650937298
404,20200501,GA,987,526,1513,0.652346332
460,20200430,GA,963,370,1333,0.722430608
516,20200429,GA,943,307,1250,0.7544
572,20200428,GA,922,292,1214,0.759472817
628,20200427,GA,903,188,1091,0.827681027
684,20200426,GA,899,2684,3583,0.250907061
740,20200425,GA,877,2662,3539,0.247810116
796,20200424,GA,869,2531,3400,0.255588235
852,20200423,GA,845,2426,3271,0.258330786
908,20200422,GA,824,2366,3190,0.25830721
964,20200421,GA,617,2246,2863,0.215508208
1020,20200420,GA,594,2211,2805,0.211764706
1076,20200419,GA,582,2163,2745,0.212021858
1132,20200418,GA,563,2026,2589,0.217458478
1188,20200417,GA,556,1988,2544,0.218553459
1244,20200416,GA,505,1954,2459,0.205368036
1300,20200415,GA,479,1847,2326,0.205932932
1356,20200414,GA,462,1811,2273,0.203255609
1412,20200413,GA,418,1735,2153,0.194147701
1468,20200412,GA,385,1706,2091,0.184122429
1524,20200411,GA,377,1597,1974,0.190982776
1580,20200410,GA,344,1470,1814,0.189636163
1636,20200409,GA,309,1357,1666,0.18547419
1692,20200408,GA,2163,1234,3397,0.636738298
1748,20200407,GA,2061,1105,3166,0.650979154
1804,20200406,GA,1929,1071,3000,0.643
1860,20200405,GA,1806,973,2779,0.649874055
1916,20200404,GA,1772,929,2701,0.656053314
1972,20200403,GA,1653,808,2461,0.67167818
2028,20200402,GA,1607,706,2313,0.694768699
2084,20200401,GA,1422,575,1997,0.712068102
2140,20200331,GA,1183,327,1510,0.783443709
2196,20200330,GA,785,2606,3391,0.231495134
2252,20200329,GA,755,2605,3360,0.224702381
2308,20200328,GA,706,2468,3174,0.222432262
2364,20200327,GA,629,2320,2949,0.213292642
2420,20200326,GA,163,2298,2461,0.066233239
2476,20200325,GA,89,1665,1754,0.050741163
2532,20200324,GA,11,1636,1647,0.00667881
2588,20200323,GA,2011,1627,3638,0.552776251
2644,20200322,GA,1837,1301,3138,0.585404716
2700,20200321,GA,1681,888,2569,0.65434021
2756,20200320,GA,1486,114,1600,0.92875
2812,20200319,GA,1021,74,1095,0.932420091
2868,20200318,GA,626,47,673,0.930163447
2924,20200317,GA,486,1,487,0.997946612
2980,20200316,GA,400,1,401,0.997506234
3035,20200315,GA,2216,1,2217,0.99954894
3086,20200314,GA,1885,1,1886,0.999469777
3137,20200313,GA,1482,1,1483,0.999325691
3188,20200312,GA,1219,1,1220,0.999180328
3239,20200311,GA,866,1,867,0.998846597
3289,20200310,GA,553,1,554,0.998194946
3339,20200309,GA,371,1,372,0.997311828
3389,20200308,GA,1909,1,1910,0.99947644
3439,20200307,GA,1758,1,1759,0.999431495
3487,20200306,GA,628,1,629,0.998410175
3520,20200305,GA,628,1,629,0.998410175
3542,20200304,GA,628,1,629,0.998410175
13,20200508,GU,516,1318,1834,0.281352236
69,20200507,GU,516,1313,1829,0.282121378
125,20200506,GU,516,1307,1823,0.283049918
181,20200505,GU,488,1296,1784,0.273542601
237,20200504,GU,488,1291,1779,0.274311411
293,20200503,GU,515,1285,1800,0.286111111
349,20200502,GU,487,1279,1766,0.275764439
405,20200501,GU,486,913,1399,0.347390994
461,20200430,GU,486,113,599,0.811352254
517,20200429,GU,485,92,577,0.840554593
573,20200428,GU,485,73,558,0.869175627
629,20200427,GU,484,61,545,0.888073394
685,20200426,GU,481,56,537,0.895716946
741,20200425,GU,481,45,526,0.914448669
797,20200424,GU,481,35,516,0.932170543
853,20200423,GU,451,21,472,0.955508475
909,20200422,GU,450,12,462,0.974025974
965,20200421,GU,448,6,454,0.986784141
1021,20200420,GU,448,2688,3136,0.142857143
1077,20200419,GU,448,2647,3095,0.144749596
1133,20200418,GU,448,2647,3095,0.144749596
1189,20200417,GU,448,2646,3094,0.14479638
1245,20200416,GU,448,2548,2996,0.14953271
1301,20200415,GU,448,2529,2977,0.150487068
1357,20200414,GU,448,2503,2951,0.151812945
1413,20200413,GU,448,2411,2859,0.156698146
1469,20200412,GU,448,2273,2721,0.164645351
1525,20200411,GU,448,2273,2721,0.164645351
1581,20200410,GU,442,2227,2669,0.165605096
1637,20200409,GU,410,2087,2497,0.164197036
1693,20200408,GU,406,2029,2435,0.166735113
1749,20200407,GU,400,1965,2365,0.169133192
1805,20200406,GU,361,1934,2295,0.157298475
1861,20200405,GU,360,1858,2218,0.162308386
1917,20200404,GU,2191,1820,4011,0.546247818
1973,20200403,GU,2096,1783,3879,0.54034545
2029,20200402,GU,2085,1762,3847,0.541980764
2085,20200401,GU,2009,1683,3692,0.544149512
2141,20200331,GU,1903,1557,3460,0.55
2197,20200330,GU,1741,1506,3247,0.53618725
2253,20200329,GU,1725,1453,3178,0.54279421
2309,20200328,GU,1719,1273,2992,0.574532086
2365,20200327,GU,1682,1273,2955,0.569204738
2421,20200326,GU,1521,1171,2692,0.565007429
2477,20200325,GU,1311,1079,2390,0.548535565
2533,20200324,GU,1236,952,2188,0.564899452
2589,20200323,GU,1024,663,1687,0.606994665
2645,20200322,GU,982,383,1365,0.719413919
2701,20200321,GU,490,209,699,0.701001431
2757,20200320,GU,457,2535,2992,0.152740642
2813,20200319,GU,371,2257,2628,0.141171994
2869,20200318,GU,2025,2034,4059,0.498891353
2925,20200317,GU,1567,1685,3252,0.481857319
2981,20200316,GU,1049,1052,2101,0.499286054
14,20200508,HI,1866,1503,3369,0.553873553
70,20200507,HI,1863,1476,3339,0.557951482
126,20200506,HI,1862,1466,3328,0.559495192
182,20200505,HI,1860,1439,3299,0.563807214
238,20200504,HI,1859,1436,3295,0.564188164
294,20200503,HI,1859,1410,3269,0.568675436
350,20200502,HI,1855,1381,3236,0.573238566
406,20200501,HI,1854,1356,3210,0.577570093
462,20200430,HI,1850,1346,3196,0.578848561
518,20200429,HI,1845,1244,3089,0.597280673
574,20200428,HI,1844,1230,3074,0.599869876
630,20200427,HI,1843,1224,3067,0.600912944
686,20200426,HI,1840,1203,3043,0.604666448
742,20200425,HI,1838,1195,3033,0.606000659
798,20200424,HI,1757,1157,2914,0.60295127
854,20200423,HI,1755,1133,2888,0.607686981
910,20200422,HI,1747,1103,2850,0.612982456
966,20200421,HI,1748,1087,2835,0.616578483
1022,20200420,HI,1746,1064,2810,0.621352313
1078,20200419,HI,1736,1037,2773,0.626036783
1134,20200418,HI,1722,995,2717,0.633787265
1190,20200417,HI,1713,980,2693,0.636093576
1246,20200416,HI,1702,932,2634,0.646165528
1302,20200415,HI,1687,801,2488,0.678054662
1358,20200414,HI,1678,773,2451,0.684618523
1414,20200413,HI,1566,753,2319,0.675291074
1470,20200412,HI,1560,700,2260,0.690265487
1526,20200411,HI,1542,689,2231,0.691169879
1582,20200410,HI,1515,577,2092,0.72418738
1638,20200409,HI,1505,563,2068,0.727756286
1694,20200408,HI,1477,511,1988,0.742957746
1750,20200407,HI,1334,409,1743,0.765347103
1806,20200406,HI,1321,409,1730,0.763583815
1862,20200405,HI,1293,346,1639,0.788895668
1918,20200404,HI,1235,265,1500,0.823333333
1974,20200403,HI,1019,129,1148,0.887630662
2030,20200402,HI,959,129,1088,0.881433824
2086,20200401,HI,837,2473,3310,0.252870091
2142,20200331,HI,834,2457,3291,0.253418414
2198,20200330,HI,574,2318,2892,0.198478562
2254,20200329,HI,516,2136,2652,0.194570136
2310,20200328,HI,399,1630,2029,0.196648595
2366,20200327,HI,329,1630,1959,0.167942828
2422,20200326,HI,2199,1630,3829,0.574301384
2478,20200325,HI,2169,1630,3799,0.570939721
2534,20200324,HI,2009,1314,3323,0.60457418
2590,20200323,HI,1725,924,2649,0.651189128
2646,20200322,HI,1551,1171,2722,0.569801616
2702,20200321,HI,1311,377,1688,0.776658768
2758,20200320,HI,961,377,1338,0.718236173
2814,20200319,HI,525,2633,3158,0.166244459
2870,20200318,HI,457,2633,3090,0.14789644
2926,20200317,HI,283,1,284,0.996478873
2982,20200316,HI,1909,1,1910,0.99947644
3036,20200315,HI,628,1,629,0.998410175
3087,20200314,HI,628,1,629,0.998410175
3138,20200313,HI,628,1,629,0.998410175
3189,20200312,HI,628,1,629,0.998410175
3240,20200311,HI,628,1,629,0.998410175
3290,20200310,HI,628,1,629,0.998410175
3340,20200309,HI,628,1,629,0.998410175
3390,20200308,HI,3,1,4,0.75
3440,20200307,HI,3,1,4,0.75
15,20200508,IA,343,2067,2410,0.142323651
71,20200507,IA,335,2009,2344,0.142918089
127,20200506,IA,303,1958,2261,0.134011499
183,20200505,IA,290,1925,2215,0.130925508
239,20200504,IA,2159,1809,3968,0.544102823
295,20200503,IA,2135,1747,3882,0.54997424
351,20200502,IA,2055,1552,3607,0.569725534
407,20200501,IA,1959,1552,3511,0.557960695
463,20200430,IA,1917,1496,3413,0.561675945
519,20200429,IA,1819,1463,3282,0.554235222
575,20200428,IA,1786,1441,3227,0.553455222
631,20200427,IA,1657,1409,3066,0.540443575
687,20200426,IA,1620,1359,2979,0.543806647
743,20200425,IA,1577,1251,2828,0.557637907
799,20200424,IA,1402,1198,2600,0.539230769
855,20200423,IA,1182,1128,2310,0.511688312
911,20200422,IA,1159,1093,2252,0.514653641
967,20200421,IA,1145,1073,2218,0.516230839
1023,20200420,IA,1073,1033,2106,0.509496676
1079,20200419,IA,798,990,1788,0.446308725
1135,20200418,IA,730,939,1669,0.437387657
1191,20200417,IA,698,809,1507,0.463171865
1247,20200416,IA,662,760,1422,0.465541491
1303,20200415,IA,282,714,996,0.28313253
1359,20200414,IA,259,661,920,0.281521739
1415,20200413,IA,209,661,870,0.240229885
1471,20200412,IA,178,624,802,0.221945137
1527,20200411,IA,159,572,731,0.21751026
1583,20200410,IA,126,503,629,0.200317965
1639,20200409,IA,96,430,526,0.182509506
1695,20200408,IA,51,356,407,0.125307125
1751,20200407,IA,18,252,270,0.066666667
1807,20200406,IA,2198,152,2350,0.935319149
1863,20200405,IA,2112,2609,4721,0.447362847
1919,20200404,IA,2018,2579,4597,0.438981945
1975,20200403,IA,1908,2474,4382,0.435417618
2031,20200402,IA,1851,2432,4283,0.43217371
2087,20200401,IA,1718,2292,4010,0.428428928
2143,20200331,IA,1565,2138,3703,0.4226303
2199,20200330,IA,1490,2102,3592,0.41481069
2255,20200329,IA,1269,1865,3134,0.404913848
2311,20200328,IA,1046,1631,2677,0.390735898
2367,20200327,IA,910,1327,2237,0.406794814
2423,20200326,IA,576,892,1468,0.392370572
2479,20200325,IA,485,892,1377,0.35221496
2535,20200324,IA,405,871,1276,0.317398119
2591,20200323,IA,327,848,1175,0.278297872
2647,20200322,IA,2169,32,2201,0.985461154
2703,20200321,IA,1895,8,1903,0.995796111
2759,20200320,IA,1521,2200,3721,0.408761086
2815,20200319,IA,1327,2512,3839,0.345662933
2871,20200318,IA,1024,2512,3536,0.28959276
2927,20200317,IA,892,2512,3404,0.262044653
2983,20200316,IA,866,2512,3378,0.256364713
3037,20200315,IA,577,2512,3089,0.186791842
3088,20200314,IA,553,2512,3065,0.180424144
3139,20200313,IA,525,2512,3037,0.172867962
3190,20200312,IA,457,2232,2689,0.169951655
3241,20200311,IA,413,1785,2198,0.187898089
3291,20200310,IA,2025,1404,3429,0.590551181
3341,20200309,IA,1049,1149,2198,0.477252047
3391,20200308,IA,2,551,553,0.003616637
3441,20200307,IA,2,551,553,0.003616637
3488,20200306,IA,2,551,553,0.003616637
16,20200508,ID,669,1245,1914,0.349529781
72,20200507,ID,666,1232,1898,0.35089568
128,20200506,ID,661,1225,1886,0.3504772
184,20200505,ID,656,1220,1876,0.349680171
240,20200504,ID,648,1199,1847,0.350839199
296,20200503,ID,648,1199,1847,0.350839199
352,20200502,ID,639,1196,1835,0.348228883
408,20200501,ID,635,1188,1823,0.348326934
464,20200430,ID,278,1163,1441,0.192921582
520,20200429,ID,269,1159,1428,0.18837535
576,20200428,ID,264,747,1011,0.261127596
632,20200427,ID,258,719,977,0.264073695
688,20200426,ID,257,709,966,0.266045549
744,20200425,ID,255,701,956,0.266736402
800,20200424,ID,243,696,939,0.258785942
856,20200423,ID,237,631,868,0.273041475
912,20200422,ID,225,594,819,0.274725275
968,20200421,ID,218,592,810,0.269135802
1024,20200420,ID,198,581,779,0.254172015
1080,20200419,ID,196,558,754,0.25994695
1136,20200418,ID,193,521,714,0.270308123
1192,20200417,ID,183,505,688,0.265988372
1248,20200416,ID,178,489,667,0.266866567
1304,20200415,ID,150,437,587,0.255536627
1360,20200414,ID,147,429,576,0.255208333
1416,20200413,ID,139,420,559,0.248658318
1472,20200412,ID,132,358,490,0.269387755
1528,20200411,ID,129,336,465,0.277419355
1584,20200410,ID,120,255,375,0.32
1640,20200409,ID,81,236,317,0.255520505
1696,20200408,ID,74,155,229,0.323144105
1752,20200407,ID,61,121,182,0.335164835
1808,20200406,ID,37,2602,2639,0.014020462
1864,20200405,ID,29,2569,2598,0.011162433
1920,20200404,ID,7,2319,2326,0.003009458
1976,20200403,ID,2125,2278,4403,0.482625483
2032,20200402,ID,1890,2124,4014,0.470852018
2088,20200401,ID,1697,2094,3791,0.447639145
2144,20200331,ID,1480,1878,3358,0.440738535
2200,20200330,ID,1227,1633,2860,0.429020979
2256,20200329,ID,974,1613,2587,0.376497874
2312,20200328,ID,907,1297,2204,0.411524501
2368,20200327,ID,604,899,1503,0.401862941
2424,20200326,ID,403,850,1253,0.321628093
2480,20200325,ID,1984,109,2093,0.947921644
2536,20200324,ID,1670,109,1779,0.938729623
2592,20200323,ID,1543,46,1589,0.971050975
2648,20200322,ID,1482,20,1502,0.986684421
2704,20200321,ID,1219,2556,3775,0.322913907
2760,20200320,ID,892,2085,2977,0.299630501
2816,20200319,ID,334,1783,2117,0.15777043
2872,20200318,ID,2128,1783,3911,0.544106367
2928,20200317,ID,1909,1480,3389,0.563293007
2984,20200316,ID,1567,1174,2741,0.571689165
3038,20200315,ID,1567,730,2297,0.682194166
3089,20200314,ID,628,730,1358,0.462444772
3140,20200313,ID,2,444,446,0.004484305
3191,20200312,ID,2,2633,2635,0.000759013
3242,20200311,ID,2,2232,2234,0.000895255
3292,20200310,ID,2,1685,1687,0.001185536
3342,20200309,ID,2,1685,1687,0.001185536
3392,20200308,ID,2,1182,1184,0.001689189
3442,20200307,ID,2,1182,1184,0.001689189
17,20200508,IL,1986,1426,3412,0.582063306
73,20200507,IL,1967,1374,3341,0.588745884
129,20200506,IL,1897,1267,3164,0.599557522
185,20200505,IL,1881,1237,3118,0.603271328
241,20200504,IL,1868,1181,3049,0.612659888
297,20200503,IL,1847,1147,2994,0.616900468
353,20200502,IL,1744,1109,2853,0.611286365
409,20200501,IL,1726,1049,2775,0.621981982
465,20200430,IL,1693,1012,2705,0.625878004
521,20200429,IL,1672,962,2634,0.634776006
577,20200428,IL,1552,831,2383,0.651279899
633,20200427,IL,1526,779,2305,0.662039046
689,20200426,IL,1501,724,2225,0.674606742
745,20200425,IL,1476,622,2098,0.703527169
801,20200424,IL,1340,550,1890,0.708994709
857,20200423,IL,1305,463,1768,0.738122172
913,20200422,IL,1286,393,1679,0.765932102
969,20200421,IL,1257,367,1624,0.774014778
1025,20200420,IL,1223,299,1522,0.803547963
1081,20200419,IL,1197,282,1479,0.809330629
1137,20200418,IL,1026,211,1237,0.829426031
1193,20200417,IL,991,183,1174,0.844122658
1249,20200416,IL,947,2665,3612,0.262181617
1305,20200415,IL,921,2625,3546,0.259729272
1361,20200414,IL,897,2544,3441,0.260680035
1417,20200413,IL,867,2515,3382,0.256357185
1473,20200412,IL,826,2427,3253,0.253919459
1529,20200411,IL,606,2357,2963,0.204522443
1585,20200410,IL,568,2267,2835,0.200352734
1641,20200409,IL,533,2196,2729,0.195309637
1697,20200408,IL,493,2084,2577,0.191307722
1753,20200407,IL,428,2006,2434,0.175842235
1809,20200406,IL,379,1930,2309,0.16414032
1865,20200405,IL,340,1814,2154,0.157845868
1921,20200404,IL,300,1724,2024,0.148221344
1977,20200403,IL,2068,1587,3655,0.565800274
2033,20200402,IL,1948,1502,3450,0.564637681
2089,20200401,IL,1832,1440,3272,0.5599022
2145,20200331,IL,1669,1249,2918,0.571967101
2201,20200330,IL,1574,1130,2704,0.582100592
2257,20200329,IL,1418,1056,2474,0.573160873
2313,20200328,IL,1123,1017,2140,0.524766355
2369,20200327,IL,1053,758,1811,0.581446715
2425,20200326,IL,734,480,1214,0.60461285
2481,20200325,IL,253,334,587,0.431005111
2537,20200324,IL,165,2607,2772,0.05952381
2593,20200323,IL,97,2463,2560,0.037890625
2649,20200322,IL,19,2290,2309,0.00822867
2705,20200321,IL,2001,1888,3889,0.514528156
2761,20200320,IL,1749,1323,3072,0.569335938
2817,20200319,IL,1488,905,2393,0.621813623
2873,20200318,IL,1022,97,1119,0.91331546
2929,20200317,IL,523,51,574,0.911149826
2985,20200316,IL,2191,2641,4832,0.45343543
3039,20200315,IL,1873,1766,3639,0.514701841
3090,20200314,IL,1535,1402,2937,0.522642152
3141,20200313,IL,1236,1268,2504,0.493610224
3192,20200312,IL,936,1176,2112,0.443181818
3243,20200311,IL,605,1111,1716,0.352564103
3293,20200310,IL,605,1111,1716,0.352564103
3343,20200309,IL,1909,826,2735,0.697989031
3393,20200308,IL,1758,826,2584,0.680340557
3443,20200307,IL,1758,826,2584,0.680340557
3489,20200306,IL,1567,775,2342,0.669086251
3521,20200305,IL,1567,677,2244,0.698306595
3543,20200304,IL,1349,377,1726,0.781575898
18,20200508,IN,896,202,1098,0.816029144
74,20200507,IN,874,182,1056,0.827651515
130,20200506,IN,852,2677,3529,0.241428167
186,20200505,IN,841,2645,3486,0.241250717
242,20200504,IN,820,2630,3450,0.237681159
298,20200503,IN,619,2555,3174,0.195022054
354,20200502,IN,608,2527,3135,0.193939394
410,20200501,IN,586,2498,3084,0.19001297
466,20200430,IN,567,2407,2974,0.19065232
522,20200429,IN,555,2376,2931,0.189355169
578,20200428,IN,535,2330,2865,0.186736475
634,20200427,IN,513,2247,2760,0.185869565
690,20200426,IN,492,2225,2717,0.181082076
746,20200425,IN,466,2210,2676,0.174140508
802,20200424,IN,430,2168,2598,0.165511932
858,20200423,IN,415,2073,2488,0.166800643
914,20200422,IN,384,2037,2421,0.158612144
970,20200421,IN,374,2005,2379,0.157208911
1026,20200420,IN,354,1961,2315,0.152915767
1082,20200419,IN,339,1857,2196,0.154371585
1138,20200418,IN,311,1790,2101,0.14802475
1194,20200417,IN,291,1757,2048,0.142089844
1250,20200416,IN,2152,1696,3848,0.559251559
1306,20200415,IN,2072,1592,3664,0.565502183
1362,20200414,IN,2047,1546,3593,0.569718898
1418,20200413,IN,2035,1518,3553,0.572755418
1474,20200412,IN,1961,1465,3426,0.572387624
1530,20200411,IN,1934,1389,3323,0.582004213
1586,20200410,IN,1825,1217,3042,0.599934254
1642,20200409,IN,1785,1137,2922,0.610882957
1698,20200408,IN,1668,1107,2775,0.601081081
1754,20200407,IN,1623,1058,2681,0.60537113
1810,20200406,IN,1458,976,2434,0.599013969
1866,20200405,IN,1399,750,2149,0.651000465
1922,20200404,IN,1187,585,1772,0.66986456
1978,20200403,IN,1116,495,1611,0.69273743
2034,20200402,IN,1056,412,1468,0.719346049
2090,20200401,IN,738,257,995,0.741708543
2146,20200331,IN,667,231,898,0.742761693
2202,20200330,IN,230,2601,2831,0.081243377
2258,20200329,IN,160,2448,2608,0.061349693
2314,20200328,IN,81,2284,2365,0.034249471
2370,20200327,IN,2211,1913,4124,0.536129971
2426,20200326,IN,1879,1611,3490,0.538395415
2482,20200325,IN,1549,918,2467,0.627888123
2538,20200324,IN,1309,890,2199,0.595270578
2594,20200323,IN,960,91,1051,0.913415794
2650,20200322,IN,830,42,872,0.951834862
2706,20200321,IN,407,2336,2743,0.148377689
2762,20200320,IN,2021,1823,3844,0.525754422
2818,20200319,IN,1725,1424,3149,0.54779295
2874,20200318,IN,1336,605,1941,0.688304997
2930,20200317,IN,1193,392,1585,0.752681388
2986,20200316,IN,914,290,1204,0.759136213
3040,20200315,IN,605,180,785,0.770700637
3091,20200314,IN,490,2373,2863,0.171149144
3142,20200313,IN,371,2158,2529,0.1466983
3193,20200312,IN,371,1948,2319,0.159982751
3244,20200311,IN,283,1430,1713,0.165207239
3294,20200310,IN,1758,1344,3102,0.566731141
3344,20200309,IN,628,1,629,0.998410175
3394,20200308,IN,628,1,629,0.998410175
3444,20200307,IN,3,1,4,0.75
3490,20200306,IN,3,1,4,0.75
19,20200508,KS,1795,1690,3485,0.515064562
75,20200507,KS,1771,1576,3347,0.529130565
131,20200506,KS,1643,1520,3163,0.519443566
187,20200505,KS,1614,1469,3083,0.523516056
243,20200504,KS,1594,1438,3032,0.525725594
299,20200503,KS,1571,1387,2958,0.531102096
355,20200502,KS,1436,1351,2787,0.515249372
411,20200501,KS,1403,1231,2634,0.532649962
467,20200430,KS,1380,1193,2573,0.536338904
523,20200429,KS,1157,1135,2292,0.504799302
579,20200428,KS,1123,1098,2221,0.505628095
635,20200427,KS,1097,1068,2165,0.50669746
691,20200426,KS,1074,1054,2128,0.504699248
747,20200425,KS,1058,1021,2079,0.508898509
803,20200424,KS,778,947,1725,0.451014493
859,20200423,KS,727,771,1498,0.485313752
915,20200422,KS,675,718,1393,0.484565686
971,20200421,KS,637,690,1327,0.480030143
1027,20200420,KS,280,652,932,0.300429185
1083,20200419,KS,249,629,878,0.283599089
1139,20200418,KS,232,589,821,0.282582217
1195,20200417,KS,207,556,763,0.27129751
1251,20200416,KS,179,501,680,0.263235294
1307,20200415,KS,157,410,567,0.276895944
1363,20200414,KS,139,350,489,0.284253579
1419,20200413,KS,125,339,464,0.269396552
1475,20200412,KS,115,263,378,0.304232804
1531,20200411,KS,95,225,320,0.296875
1587,20200410,KS,58,132,190,0.305263158
1643,20200409,KS,38,2591,2629,0.014454165
1699,20200408,KS,17,2565,2582,0.006584043
1755,20200407,KS,2170,2464,4634,0.468277946
1811,20200406,KS,2099,2442,4541,0.462232988
1867,20200405,KS,1994,2305,4299,0.463828797
1923,20200404,KS,1907,2137,4044,0.471562809
1979,20200403,KS,1859,2116,3975,0.467672956
2035,20200402,KS,1721,2092,3813,0.451350643
2091,20200401,KS,1557,1884,3441,0.452484743
2147,20200331,KS,1493,1669,3162,0.472169513
2203,20200330,KS,1310,1642,2952,0.443766938
2259,20200329,KS,1235,1622,2857,0.432271614
2315,20200328,KS,974,1321,2295,0.424400871
2371,20200327,KS,831,1289,2120,0.391981132
2427,20200326,KS,551,916,1467,0.375596455
2483,20200325,KS,407,877,1284,0.316978193
2539,20200324,KS,2210,852,3062,0.72175049
2595,20200323,KS,2085,1703,3788,0.550422386
2651,20200322,KS,1873,1703,3576,0.523769575
2707,20200321,KS,1719,1703,3422,0.502337814
2763,20200320,KS,1508,1703,3211,0.469635628
2819,20200319,KS,1273,1703,2976,0.427755376
2875,20200318,KS,525,1703,2228,0.235637343
2931,20200317,KS,490,1579,2069,0.236829386
2987,20200316,KS,334,680,1014,0.32938856
3041,20200315,KS,2025,457,2482,0.815874295
3092,20200314,KS,1758,2633,4391,0.400364382
3143,20200313,KS,1758,2633,4391,0.400364382
3194,20200312,KS,1349,1685,3034,0.444627554
3245,20200311,KS,3,1685,1688,0.001777251
3295,20200310,KS,3,688,691,0.004341534
3345,20200309,KS,3,219,222,0.013513514
3395,20200308,KS,3,219,222,0.013513514
3445,20200307,KS,2,219,221,0.009049774
3491,20200306,KS,2,1610,1612,0.001240695
20,20200508,KY,1768,2384,4152,0.425818882
76,20200507,KY,1665,2354,4019,0.41428216
132,20200506,KY,1651,2007,3658,0.45133953
188,20200505,KY,1594,1995,3589,0.444134857
244,20200504,KY,1583,1973,3556,0.445163105
300,20200503,KY,1450,1959,3409,0.425344676
356,20200502,KY,1450,1959,3409,0.425344676
412,20200501,KY,1431,1943,3374,0.424125667
468,20200430,KY,1414,1852,3266,0.432945499
524,20200429,KY,1394,1827,3221,0.432784849
580,20200428,KY,1367,1758,3125,0.43744
636,20200427,KY,1359,1755,3114,0.436416185
692,20200426,KY,1180,1712,2892,0.40802213
748,20200425,KY,1161,1689,2850,0.407368421
804,20200424,KY,1122,1591,2713,0.41356432
860,20200423,KY,1106,1414,2520,0.438888889
916,20200422,KY,1077,1350,2427,0.443757726
972,20200421,KY,1057,1261,2318,0.455996549
1028,20200420,KY,806,1258,2064,0.390503876
1084,20200419,KY,763,1255,2018,0.378097126
1140,20200418,KY,732,1215,1947,0.37596302
1196,20200417,KY,718,1191,1909,0.376113148
1252,20200416,KY,689,1151,1840,0.374456522
1308,20200415,KY,674,1132,1806,0.373200443
1364,20200414,KY,642,1100,1742,0.368541906
1420,20200413,KY,273,1070,1343,0.203276247
1476,20200412,KY,244,1035,1279,0.190774042
1532,20200411,KY,204,1031,1235,0.165182186
1588,20200410,KY,204,1031,1235,0.165182186
1644,20200409,KY,118,940,1058,0.111531191
1700,20200408,KY,52,940,992,0.052419355
1756,20200407,KY,5,774,779,0.006418485
1812,20200406,KY,2203,711,2914,0.756005491
1868,20200405,KY,2181,579,2760,0.790217391
1924,20200404,KY,2093,512,2605,0.803454894
1980,20200403,KY,2010,317,2327,0.863773098
2036,20200402,KY,1899,2288,4187,0.453546692
2092,20200401,KY,1754,2140,3894,0.450436569
2148,20200331,KY,1555,2112,3667,0.424052359
2204,20200330,KY,1507,1895,3402,0.442974721
2260,20200329,KY,1345,1874,3219,0.417831625
2316,20200328,KY,1211,1658,2869,0.422098292
2372,20200327,KY,934,1330,2264,0.41254417
2428,20200326,KY,627,1282,1909,0.328444212
2484,20200325,KY,521,915,1436,0.36281337
2540,20200324,KY,405,96,501,0.808383234
2596,20200323,KY,326,96,422,0.772511848
2652,20200322,KY,2216,69,2285,0.969803063
2708,20200321,KY,1707,2346,4053,0.421169504
2764,20200320,KY,1543,2086,3629,0.425186002
2820,20200319,KY,1285,1779,3064,0.419386423
2876,20200318,KY,961,1507,2468,0.389384117
2932,20200317,KY,866,1269,2135,0.405620609
2988,20200316,KY,839,1080,1919,0.437206879
3042,20200315,KY,525,471,996,0.527108434
3093,20200314,KY,457,471,928,0.492456897
3144,20200313,KY,334,203,537,0.621973929
3195,20200312,KY,2025,2018,4043,0.500865694
3246,20200311,KY,2025,1785,3810,0.531496063
3296,20200310,KY,1758,1213,2971,0.59171996
3346,20200309,KY,1349,688,2037,0.662248405
3396,20200308,KY,3,398,401,0.007481297
3446,20200307,KY,3,2561,2564,0.001170047
3492,20200306,KY,2,2276,2278,0.000877963
21,20200508,LA,1207,726,1933,0.624418003
77,20200507,LA,1202,721,1923,0.625065003
133,20200506,LA,1198,675,1873,0.63961559
189,20200505,LA,1038,618,1656,0.626811594
245,20200504,LA,1034,596,1630,0.634355828
301,20200503,LA,1030,542,1572,0.655216285
357,20200502,LA,1025,533,1558,0.657894737
413,20200501,LA,1010,472,1482,0.681511471
469,20200430,LA,1002,453,1455,0.688659794
525,20200429,LA,992,391,1383,0.717281273
581,20200428,LA,988,376,1364,0.724340176
637,20200427,LA,985,313,1298,0.758859784
693,20200426,LA,972,296,1268,0.766561514
749,20200425,LA,969,278,1247,0.777064956
805,20200424,LA,962,277,1239,0.776432607
861,20200423,LA,948,276,1224,0.774509804
917,20200422,LA,937,274,1211,0.77374071
973,20200421,LA,925,274,1199,0.77147623
1029,20200420,LA,919,274,1193,0.770326907
1085,20200419,LA,905,273,1178,0.768251273
1141,20200418,LA,901,288,1189,0.757779647
1197,20200417,LA,895,215,1110,0.806306306
1253,20200416,LA,876,195,1071,0.817927171
1309,20200415,LA,854,2686,3540,0.241242938
1365,20200414,LA,846,2666,3512,0.240888383
1421,20200413,LA,840,2543,3383,0.248300325
1477,20200412,LA,822,2514,3336,0.246402878
1533,20200411,LA,814,2400,3214,0.253266957
1589,20200410,LA,607,2363,2970,0.204377104
1645,20200409,LA,581,2249,2830,0.205300353
1701,20200408,LA,554,2195,2749,0.201527828
1757,20200407,LA,530,2063,2593,0.204396452
1813,20200406,LA,477,1987,2464,0.193587662
1869,20200405,LA,414,1807,2221,0.186402521
1925,20200404,LA,386,1786,2172,0.17771639
1981,20200403,LA,297,1728,2025,0.146666667
2037,20200402,LA,2134,1700,3834,0.556598852
2093,20200401,LA,1787,1590,3377,0.529167901
2149,20200331,LA,1593,1446,3039,0.524185587
2205,20200330,LA,1351,1345,2696,0.50111276
2261,20200329,LA,1131,1091,2222,0.5090009
2317,20200328,LA,1093,998,2091,0.522716404
2373,20200327,LA,771,763,1534,0.502607562
2429,20200326,LA,691,578,1269,0.544523247
2485,20200325,LA,234,2590,2824,0.08286119
2541,20200324,LA,126,2287,2413,0.052217157
2597,20200323,LA,63,1655,1718,0.036670547
2653,20200322,LA,2094,898,2992,0.69986631
2709,20200321,LA,1746,858,2604,0.670506912
2765,20200320,LA,1547,2033,3580,0.432122905
2821,20200319,LA,1283,1782,3065,0.418597064
2877,20200318,LA,926,1455,2381,0.388912222
2933,20200317,LA,454,1240,1694,0.268004723
2989,20200316,LA,365,789,1154,0.316291161
3043,20200315,LA,2169,609,2778,0.780777538
3094,20200314,LA,1682,216,1898,0.886195996
3145,20200313,LA,1300,1535,2835,0.458553792
3196,20200312,LA,457,1535,1992,0.229417671
3247,20200311,LA,1758,1535,3293,0.533859702
3297,20200310,LA,3,219,222,0.013513514
3347,20200309,LA,3,1863,1866,0.001607717
3397,20200308,LA,2,1863,1865,0.001072386
3447,20200307,LA,2,1,3,0.666666667
22,20200508,MA,1998,1266,3264,0.612132353
78,20200507,MA,1985,1212,3197,0.620894589
134,20200506,MA,1979,1178,3157,0.626860944
190,20200505,MA,1966,1172,3138,0.626513703
246,20200504,MA,1904,1146,3050,0.624262295
302,20200503,MA,1896,1112,3008,0.630319149
358,20200502,MA,1886,1078,2964,0.636302294
414,20200501,MA,1874,1047,2921,0.641561109
470,20200430,MA,1857,1007,2864,0.648393855
526,20200429,MA,1835,960,2795,0.656529517
582,20200428,MA,1743,835,2578,0.676105508
638,20200427,MA,1728,791,2519,0.685986503
694,20200426,MA,1711,778,2489,0.687424669
750,20200425,MA,1700,728,2428,0.700164745
806,20200424,MA,1675,674,2349,0.713069391
862,20200423,MA,1545,610,2155,0.716937355
918,20200422,MA,1513,535,2048,0.738769531
974,20200421,MA,1496,527,2023,0.739495798
1030,20200420,MA,1475,459,1934,0.762668046
1086,20200419,MA,1341,395,1736,0.772465438
1142,20200418,MA,1318,378,1696,0.777122642
1198,20200417,MA,1287,302,1589,0.809943361
1254,20200416,MA,1243,268,1511,0.822634017
1310,20200415,MA,1037,184,1221,0.849303849
1366,20200414,MA,1005,2678,3683,0.272875373
1422,20200413,MA,973,2653,3626,0.268339768
1478,20200412,MA,941,2620,3561,0.264251615
1534,20200411,MA,878,2536,3414,0.257176333
1590,20200410,MA,828,2501,3329,0.24872334
1646,20200409,MA,591,2395,2986,0.197923644
1702,20200408,MA,539,2331,2870,0.187804878
1758,20200407,MA,494,2218,2712,0.182153392
1814,20200406,MA,435,2178,2613,0.166475316
1870,20200405,MA,383,2080,2463,0.155501421
1926,20200404,MA,350,2040,2390,0.146443515
1982,20200403,MA,298,1956,2254,0.132209406
2038,20200402,MA,2065,1816,3881,0.532079361
2094,20200401,MA,1942,1750,3692,0.526002167
2150,20200331,MA,1798,1674,3472,0.517857143
2206,20200330,MA,1632,1538,3170,0.514826498
2262,20200329,MA,1448,1460,2908,0.497936726
2318,20200328,MA,1369,1364,2733,0.500914746
2374,20200327,MA,1072,1156,2228,0.481149013
2430,20200326,MA,695,981,1676,0.414677804
2486,20200325,MA,220,742,962,0.228690229
2542,20200324,MA,21,349,370,0.056756757
2598,20200323,MA,1893,2444,4337,0.436476827
2654,20200322,MA,1716,1887,3603,0.476269775
2710,20200321,MA,1491,1657,3148,0.473634053
2766,20200320,MA,1230,1333,2563,0.47990636
2822,20200319,MA,890,919,1809,0.491984522
2878,20200318,MA,520,855,1375,0.378181818
2934,20200317,MA,368,86,454,0.810572687
2990,20200316,MA,2208,25,2233,0.988804299
3044,20200315,MA,1873,2070,3943,0.475019021
3095,20200314,MA,1327,1,1328,0.999246988
3146,20200313,MA,892,1,893,0.998880179
3197,20200312,MA,2025,1,2026,0.999506417
23,20200508,MD,1199,365,1564,0.766624041
79,20200507,MD,1032,308,1340,0.770149254
135,20200506,MD,1006,293,1299,0.774441878
191,20200505,MD,986,283,1269,0.776989756
247,20200504,MD,967,269,1236,0.78236246
303,20200503,MD,942,205,1147,0.821272886
359,20200502,MD,918,173,1091,0.841429881
415,20200501,MD,900,2671,3571,0.252030244
471,20200430,MD,850,2629,3479,0.244323081
527,20200429,MD,825,2614,3439,0.239895318
583,20200428,MD,815,2546,3361,0.242487355
639,20200427,MD,613,2534,3147,0.194788688
695,20200426,MD,585,2415,3000,0.195
751,20200425,MD,565,2340,2905,0.194492255
807,20200424,MD,536,2244,2780,0.192805755
863,20200423,MD,507,2194,2701,0.187708256
919,20200422,MD,476,2166,2642,0.18016654
975,20200421,MD,461,2077,2538,0.181639086
1031,20200420,MD,431,2049,2480,0.173790323
1087,20200419,MD,392,2002,2394,0.16374269
1143,20200418,MD,380,1968,2348,0.161839864
1199,20200417,MD,347,1923,2270,0.152863436
1255,20200416,MD,315,1828,2143,0.146990201
1311,20200415,MD,286,1777,2063,0.138633059
1367,20200414,MD,2148,1753,3901,0.550628044
1423,20200413,MD,2071,1713,3784,0.54730444
1479,20200412,MD,2034,1695,3729,0.545454545
1535,20200411,MD,1947,1594,3541,0.549844677
1591,20200410,MD,1830,1545,3375,0.542222222
1647,20200409,MD,1774,1493,3267,0.543005816
1703,20200408,MD,1626,1419,3045,0.533990148
1759,20200407,MD,1393,1190,2583,0.539295393
1815,20200406,MD,1358,1134,2492,0.54494382
1871,20200405,MD,1138,1102,2240,0.508035714
1927,20200404,MD,1069,1029,2098,0.509532888
1983,20200403,MD,774,950,1724,0.448955916
2039,20200402,MD,697,772,1469,0.47447243
2095,20200401,MD,279,695,974,0.286447639
2151,20200331,MD,194,516,710,0.273239437
2207,20200330,MD,136,415,551,0.246823956
2263,20200329,MD,84,335,419,0.200477327
2319,20200328,MD,2220,244,2464,0.900974026
2375,20200327,MD,2012,2643,4655,0.432223416
2431,20200326,MD,1746,2643,4389,0.397812714
2487,20200325,MD,1489,2643,4132,0.36035818
2543,20200324,MD,1284,2643,3927,0.32696715
2599,20200323,MD,1022,2643,3665,0.278854025
2655,20200322,MD,929,2643,3572,0.260078387
2711,20200321,MD,621,2643,3264,0.190257353
2767,20200320,MD,488,2643,3131,0.155860747
2823,20200319,MD,330,2643,2973,0.110998991
2879,20200318,MD,2101,2643,4744,0.442875211
2935,20200317,MD,1734,2643,4377,0.396161755
2991,20200316,MD,1311,2643,3954,0.331562974
3045,20200315,MD,1219,2643,3862,0.315639565
3096,20200314,MD,961,2643,3604,0.266648169
3147,20200313,MD,553,2643,3196,0.173028786
3198,20200312,MD,371,2643,3014,0.123092236
3248,20200311,MD,2128,2643,4771,0.446028086
3298,20200310,MD,1758,2557,4315,0.407415991
3348,20200309,MD,1567,2360,3927,0.39903234
3398,20200308,MD,1049,1948,2997,0.350016683
3448,20200307,MD,1049,1685,2734,0.383686906
3493,20200306,MD,1049,1149,2198,0.477252047
3522,20200305,MD,2,688,690,0.002898551
24,20200508,ME,124,1020,1144,0.108391608
80,20200507,ME,113,1020,1133,0.099735216
136,20200506,ME,93,1020,1113,0.083557951
192,20200505,ME,79,811,890,0.088764045
248,20200504,ME,71,811,882,0.080498866
304,20200503,ME,67,811,878,0.076309795
360,20200502,ME,53,811,864,0.061342593
416,20200501,ME,44,811,855,0.051461988
472,20200430,ME,35,811,846,0.041371158
528,20200429,ME,20,811,831,0.024067389
584,20200428,ME,14,654,668,0.020958084
640,20200427,ME,10,654,664,0.015060241
696,20200426,ME,8,654,662,0.012084592
752,20200425,ME,2218,654,2872,0.772284123
808,20200424,ME,2206,654,2860,0.771328671
864,20200423,ME,2193,654,2847,0.77028451
920,20200422,ME,2174,654,2828,0.76874116
976,20200421,ME,2122,479,2601,0.815840062
1032,20200420,ME,2115,479,2594,0.815343099
1088,20200419,ME,2111,479,2590,0.815057915
1144,20200418,ME,2100,479,2579,0.814269097
1200,20200417,ME,2089,479,2568,0.81347352
1256,20200416,ME,2024,479,2503,0.808629644
1312,20200415,ME,2010,479,2489,0.807553234
1368,20200414,ME,1988,250,2238,0.888293119
1424,20200413,ME,1907,250,2157,0.884098285
1480,20200412,ME,1870,2096,3966,0.471507816
1536,20200411,ME,1853,2096,3949,0.469232717
1592,20200410,ME,1750,2096,3846,0.455018201
1648,20200409,ME,1729,2096,3825,0.452026144
1704,20200408,ME,1705,2096,3801,0.448566167
1760,20200407,ME,1688,2096,3784,0.446088795
1816,20200406,ME,1566,2096,3662,0.427635172
1872,20200405,ME,1546,2096,3642,0.424492037
1928,20200404,ME,1532,2096,3628,0.422271224
1984,20200403,ME,1503,2096,3599,0.417616004
2040,20200402,ME,1324,2096,3420,0.387134503
2096,20200401,ME,1280,2096,3376,0.379146919
2152,20200331,ME,1212,2096,3308,0.366384522
2208,20200330,ME,997,1299,2296,0.434233449
2264,20200329,ME,953,1299,2252,0.423179396
2320,20200328,ME,856,1299,2155,0.397215777
2376,20200327,ME,551,1299,1850,0.297837838
2432,20200326,ME,519,1299,1818,0.285478548
2488,20200325,ME,488,1287,1775,0.274929577
2544,20200324,ME,406,1276,1682,0.24137931
2600,20200323,ME,330,909,1239,0.266343826
2656,20200322,ME,2123,865,2988,0.710508701
2712,20200321,ME,1984,865,2849,0.696384696
2768,20200320,ME,1734,865,2599,0.667179684
2824,20200319,ME,1699,844,2543,0.668108533
2880,20200318,ME,1495,90,1585,0.943217666
2936,20200317,ME,1236,43,1279,0.966379984
2992,20200316,ME,553,2404,2957,0.187013865
3046,20200315,ME,1049,2617,3666,0.286142935
3097,20200314,ME,1049,2617,3666,0.286142935
3148,20200313,ME,1049,2617,3666,0.286142935
3199,20200312,ME,3,2203,2206,0.001359927
3249,20200311,ME,2,1705,1707,0.001171646
3299,20200310,ME,2,927,929,0.002152853
3349,20200309,ME,2,3,5,0.4
3399,20200308,ME,2,3,5,0.4
3449,20200307,ME,2,3,5,0.4
25,20200508,MI,1536,1008,2544,0.603773585
81,20200507,MI,1524,954,2478,0.615012107
137,20200506,MI,1523,790,2313,0.658452227
193,20200505,MI,1510,736,2246,0.672306322
249,20200504,MI,1502,736,2238,0.671134942
305,20200503,MI,1500,685,2185,0.686498856
361,20200502,MI,1497,619,2116,0.707466919
417,20200501,MI,1485,546,2031,0.731166913
473,20200430,MI,1474,470,1944,0.758230453
529,20200429,MI,1464,446,1910,0.766492147
585,20200428,MI,1339,382,1721,0.778036026
641,20200427,MI,1329,312,1641,0.809872029
697,20200426,MI,1319,284,1603,0.82283219
753,20200425,MI,1313,201,1514,0.867239102
809,20200424,MI,1303,2683,3986,0.326894129
865,20200423,MI,1288,2634,3922,0.328403876
921,20200422,MI,1263,2520,3783,0.333862014
977,20200421,MI,1245,2520,3765,0.330677291
1033,20200420,MI,1237,2502,3739,0.330837122
1089,20200419,MI,1221,2416,3637,0.33571625
1145,20200418,MI,1204,2251,3455,0.348480463
1201,20200417,MI,1194,2251,3445,0.34658926
1257,20200416,MI,1028,2204,3232,0.318069307
1313,20200415,MI,1003,2164,3167,0.316703505
1369,20200414,MI,983,2074,3057,0.321557082
1425,20200413,MI,945,2035,2980,0.317114094
1481,20200412,MI,924,1994,2918,0.316655243
1537,20200411,MI,906,1950,2856,0.317226891
1593,20200410,MI,879,1848,2727,0.322332233
1649,20200409,MI,844,1774,2618,0.322383499
1705,20200408,MI,821,1774,2595,0.316377649
1761,20200407,MI,616,1774,2390,0.257740586
1817,20200406,MI,592,1722,2314,0.255834054
1873,20200405,MI,562,1672,2234,0.251566697
1929,20200404,MI,532,1542,2074,0.256509161
1985,20200403,MI,498,1445,1943,0.256304683
2041,20200402,MI,460,1353,1813,0.253723111
2097,20200401,MI,393,1189,1582,0.248419722
2153,20200331,MI,356,1074,1430,0.248951049
2209,20200330,MI,318,972,1290,0.246511628
2265,20200329,MI,284,574,858,0.331002331
2321,20200328,MI,2141,485,2626,0.815308454
2377,20200327,MI,2056,347,2403,0.85559717
2433,20200326,MI,1951,133,2084,0.936180422
2489,20200325,MI,1912,2308,4220,0.453080569
2545,20200324,MI,1789,1904,3693,0.484430003
2601,20200323,MI,1648,1648,3296,0.5
2657,20200322,MI,1578,1324,2902,0.543762922
2713,20200321,MI,1415,1323,2738,0.516800584
2769,20200320,MI,1352,906,2258,0.598759965
2825,20200319,MI,1108,100,1208,0.917218543
2881,20200318,MI,800,32,832,0.961538462
2937,20200317,MI,712,2181,2893,0.246111303
2993,20200316,MI,267,1207,1474,0.181139756
3047,20200315,MI,154,958,1112,0.138489209
3098,20200314,MI,69,958,1027,0.067185979
3149,20200313,MI,2197,452,2649,0.829369573
3200,20200312,MI,1969,2617,4586,0.429350196
3250,20200311,MI,1565,2034,3599,0.434843012
3300,20200310,MI,1299,1582,2881,0.450885109
3350,20200309,MI,954,1514,2468,0.386547812
3400,20200308,MI,551,1149,1700,0.324117647
3450,20200307,MI,410,739,1149,0.356832028
3494,20200306,MI,2210,2430,4640,0.476293103
3523,20200305,MI,1978,2430,4408,0.448729583
3544,20200304,MI,1689,1,1690,0.999408284
3554,20200303,MI,1273,1,1274,0.999215071
3557,20200302,MI,577,1,578,0.998269896
3560,20200301,MI,2128,1,2129,0.999530296
26,20200508,MN,288,2618,2906,0.099105299
82,20200507,MN,2146,2551,4697,0.456887375
138,20200506,MN,2050,2525,4575,0.448087432
194,20200505,MN,1957,2486,4443,0.440468152
250,20200504,MN,1924,2419,4343,0.443011743
306,20200503,MN,1807,2390,4197,0.430545628
362,20200502,MN,1775,2356,4131,0.429678044
418,20200501,MN,1642,2259,3901,0.420917713
474,20200430,MN,1584,2207,3791,0.417831707
530,20200429,MN,1424,2174,3598,0.395775431
586,20200428,MN,1374,2081,3455,0.397684515
642,20200427,MN,1168,2043,3211,0.363749611
698,20200426,MN,1137,2010,3147,0.361296473
754,20200425,MN,1119,1971,3090,0.362135922
810,20200424,MN,1075,1929,3004,0.357856192
866,20200423,MN,805,1838,2643,0.304578131
922,20200422,MN,764,1797,2561,0.298320968
978,20200421,MN,739,1770,2509,0.294539657
1034,20200420,MN,725,1754,2479,0.292456636
1090,20200419,MN,703,1729,2432,0.2890625
1146,20200418,MN,677,1707,2384,0.28397651
1202,20200417,MN,650,1680,2330,0.278969957
1258,20200416,MN,261,1602,1863,0.140096618
1314,20200415,MN,240,1572,1812,0.132450331
1370,20200414,MN,205,1547,1752,0.117009132
1426,20200413,MN,191,1526,1717,0.111240536
1482,20200412,MN,185,1499,1684,0.109857482
1538,20200411,MN,140,1450,1590,0.088050314
1594,20200410,MN,114,1412,1526,0.074705111
1650,20200409,MN,86,1378,1464,0.058743169
1706,20200408,MN,55,1257,1312,0.041920732
1762,20200407,MN,26,1219,1245,0.020883534
1818,20200406,MN,2213,1187,3400,0.650882353
1874,20200405,MN,2192,1138,3330,0.658258258
1930,20200404,MN,2109,1096,3205,0.658034321
1986,20200403,MN,2020,1061,3081,0.655631289
2042,20200402,MN,1992,991,2983,0.66778411
2098,20200401,MN,1902,942,2844,0.668776371
2154,20200331,MN,1866,798,2664,0.70045045
2210,20200330,MN,1738,751,2489,0.698272399
2266,20200329,MN,1677,692,2369,0.707893626
2322,20200328,MN,1514,575,2089,0.724748684
2378,20200327,MN,1347,427,1774,0.759301015
2434,20200326,MN,1282,346,1628,0.787469287
2490,20200325,MN,1021,229,1250,0.8168
2546,20200324,MN,975,1893,2868,0.339958159
2602,20200323,MN,910,1639,2549,0.357002746
2658,20200322,MN,552,1639,2191,0.251939754
2714,20200321,MN,455,1338,1793,0.25376464
2770,20200320,MN,365,1328,1693,0.215593621
2826,20200319,MN,2123,923,3046,0.696979645
2882,20200318,MN,2009,902,2911,0.690140845
2938,20200317,MN,1834,866,2700,0.679259259
2994,20200316,MN,1707,105,1812,0.94205298
3048,20200315,MN,1285,56,1341,0.958240119
3099,20200314,MN,839,2530,3369,0.249035322
3150,20200313,MN,457,1998,2455,0.186150713
3201,20200312,MN,2128,1372,3500,0.608
3251,20200311,MN,1567,1013,2580,0.607364341
3301,20200310,MN,1049,447,1496,0.701203209
3351,20200309,MN,628,2485,3113,0.201734661
3401,20200308,MN,3,1826,1829,0.001640241
3451,20200307,MN,3,1826,1829,0.001640241
3495,20200306,MN,2,1514,1516,0.001319261
27,20200508,MO,2150,2682,4832,0.444950331
83,20200507,MO,2144,2644,4788,0.447786132
139,20200506,MO,2131,2622,4753,0.448348412
195,20200505,MO,2069,2537,4606,0.4491967
251,20200504,MO,2060,2511,4571,0.45066725
307,20200503,MO,2042,2378,4420,0.46199095
363,20200502,MO,2030,2378,4408,0.460526316
419,20200501,MO,1955,2378,4333,0.451188553
475,20200430,MO,1940,2364,4304,0.450743494
531,20200429,MO,1932,2268,4200,0.46
587,20200428,MO,1928,2216,4144,0.465250965
643,20200427,MO,1919,2187,4106,0.467364832
699,20200426,MO,1833,2179,4012,0.456879362
755,20200425,MO,1817,2150,3967,0.458028737
811,20200424,MO,1804,2065,3869,0.466270354
867,20200423,MO,1782,1970,3752,0.474946695
923,20200422,MO,1769,1949,3718,0.475793437
979,20200421,MO,1667,1941,3608,0.462028825
1035,20200420,MO,1650,1919,3569,0.462314374
1091,20200419,MO,1636,1834,3470,0.471469741
1147,20200418,MO,1625,1834,3459,0.469788956
1203,20200417,MO,1599,1794,3393,0.471264368
1259,20200416,MO,1579,1773,3352,0.471062053
1315,20200415,MO,1452,1749,3201,0.453608247
1371,20200414,MO,1429,1725,3154,0.45307546
1427,20200413,MO,1396,1686,3082,0.452952628
1483,20200412,MO,1370,1686,3056,0.448298429
1539,20200411,MO,1350,1588,2938,0.459496256
1595,20200410,MO,1165,1529,2694,0.432442465
1651,20200409,MO,1130,1477,2607,0.433448408
1707,20200408,MO,1096,1362,2458,0.445890968
1763,20200407,MO,1055,1235,2290,0.46069869
1819,20200406,MO,765,1185,1950,0.392307692
1875,20200405,MO,707,1104,1811,0.390392049
1931,20200404,MO,689,1032,1721,0.400348635
1987,20200403,MO,658,805,1463,0.449760766
2043,20200402,MO,242,712,954,0.253668763
2099,20200401,MO,176,584,760,0.231578947
2155,20200331,MO,112,508,620,0.180645161
2211,20200330,MO,12,411,423,0.028368794
2267,20200329,MO,2095,246,2341,0.894916702
2323,20200328,MO,2095,122,2217,0.944970681
2379,20200327,MO,1890,1534,3424,0.551985981
2435,20200326,MO,1676,1534,3210,0.52211838
2491,20200325,MO,1297,1534,2831,0.458141999
2547,20200324,MO,598,1534,2132,0.280487805
2603,20200323,MO,598,1534,2132,0.280487805
2659,20200322,MO,2169,1534,3703,0.585741291
2715,20200321,MO,1984,1534,3518,0.563956794
2771,20200320,MO,1543,1534,3077,0.501462463
2827,20200319,MO,914,1373,2287,0.399650197
2883,20200318,MO,413,1145,1558,0.26508344
2939,20200317,MO,2025,963,2988,0.677710843
2995,20200316,MO,1758,673,2431,0.723159194
3049,20200315,MO,1567,368,1935,0.809819121
3100,20200314,MO,1349,2612,3961,0.340570563
3151,20200313,MO,628,2338,2966,0.211732974
3202,20200312,MO,3,2190,2193,0.001367989
3252,20200311,MO,3,1,4,0.75
3302,20200310,MO,3,1,4,0.75
3352,20200309,MO,3,1,4,0.75
3402,20200308,MO,3,1,4,0.75
3452,20200307,MO,2,1,3,0.666666667
28,20200508,MP,490,873,1363,0.359501101
84,20200507,MP,490,99,589,0.831918506
140,20200506,MP,490,99,589,0.831918506
196,20200505,MP,457,99,556,0.821942446
252,20200504,MP,457,49,506,0.903162055
308,20200503,MP,457,49,506,0.903162055
364,20200502,MP,457,2642,3099,0.147466925
420,20200501,MP,457,2382,2839,0.160972173
476,20200430,MP,457,2071,2528,0.180775316
532,20200429,MP,457,1001,1458,0.313443073
588,20200428,MP,457,1937,2394,0.190893901
644,20200427,MP,457,1937,2394,0.190893901
700,20200426,MP,457,1937,2394,0.190893901
756,20200425,MP,457,1937,2394,0.190893901
812,20200424,MP,457,1937,2394,0.190893901
868,20200423,MP,457,1937,2394,0.190893901
924,20200422,MP,457,1937,2394,0.190893901
980,20200421,MP,457,1937,2394,0.190893901
1036,20200420,MP,457,1937,2394,0.190893901
1092,20200419,MP,457,1705,2162,0.211378353
1148,20200418,MP,457,1705,2162,0.211378353
1204,20200417,MP,413,1705,2118,0.194995279
1260,20200416,MP,413,1182,1595,0.258934169
1316,20200415,MP,413,1182,1595,0.258934169
1372,20200414,MP,413,1182,1595,0.258934169
1428,20200413,MP,334,1182,1516,0.220316623
1484,20200412,MP,334,1182,1516,0.220316623
1540,20200411,MP,334,1182,1516,0.220316623
1596,20200410,MP,334,1182,1516,0.220316623
1652,20200409,MP,334,1182,1516,0.220316623
1708,20200408,MP,334,1182,1516,0.220316623
1764,20200407,MP,2025,551,2576,0.786102484
1820,20200406,MP,2025,398,2423,0.835740817
1876,20200405,MP,2025,398,2423,0.835740817
1932,20200404,MP,2025,398,2423,0.835740817
1988,20200403,MP,2025,398,2423,0.835740817
2044,20200402,MP,2025,398,2423,0.835740817
2100,20200401,MP,1758,1,1759,0.999431495
2156,20200331,MP,628,1,629,0.998410175
2212,20200330,MP,628,1,629,0.998410175
2268,20200329,MP,628,1,629,0.998410175
2324,20200328,MP,628,1,629,0.998410175
2380,20200327,MP,2,1,3,0.666666667
2436,20200326,MP,2,1,3,0.666666667
2492,20200325,MP,2,1,3,0.666666667
2548,20200324,MP,2,1,3,0.666666667
2604,20200323,MP,2,1,3,0.666666667
2660,20200322,MP,2,1,3,0.666666667
2716,20200321,MP,2,1,3,0.666666667
2772,20200320,MP,2,1,3,0.666666667
2828,20200319,MP,2,1,3,0.666666667
2884,20200318,MP,2,1,3,0.666666667
2940,20200317,MP,2,1,3,0.666666667
2996,20200316,MP,2,1,3,0.666666667
29,20200508,MS,2130,2349,4479,0.475552579
85,20200507,MS,2058,2349,4407,0.466984343
141,20200506,MS,2045,2349,4394,0.465407374
197,20200505,MS,2033,2349,4382,0.463943405
253,20200504,MS,1958,2343,4301,0.455242967
309,20200503,MS,1939,2326,4265,0.454630715
365,20200502,MS,1936,2233,4169,0.464379947
421,20200501,MS,1922,2193,4115,0.467071689
477,20200430,MS,1816,2078,3894,0.4663585
533,20200429,MS,1801,2078,3879,0.464294921
589,20200428,MS,1784,2059,3843,0.464220661
645,20200427,MS,1764,2041,3805,0.463600526
701,20200426,MS,1663,1996,3659,0.454495764
757,20200425,MS,1640,1972,3612,0.454042082
813,20200424,MS,1612,1920,3532,0.456398641
869,20200423,MS,1586,1920,3506,0.45236737
925,20200422,MS,1451,1842,3293,0.440631643
981,20200421,MS,1432,1812,3244,0.441430333
1037,20200420,MS,1411,1801,3212,0.439290162
1093,20200419,MS,1382,1474,2856,0.483893557
1149,20200418,MS,1190,1474,2664,0.446696697
1205,20200417,MS,1164,1474,2638,0.441243366
1261,20200416,MS,1142,1474,2616,0.436544343
1317,20200415,MS,1103,1474,2577,0.428017074
1373,20200414,MS,1063,1474,2537,0.418998818
1429,20200413,MS,805,1214,2019,0.398712234
1485,20200412,MS,780,765,1545,0.504854369
1541,20200411,MS,754,765,1519,0.496379197
1597,20200410,MS,724,765,1489,0.486232371
1653,20200409,MS,683,765,1448,0.471685083
1709,20200408,MS,631,765,1396,0.452005731
1765,20200407,MS,263,765,1028,0.255836576
1821,20200406,MS,219,765,984,0.222560976
1877,20200405,MS,189,1896,2085,0.090647482
1933,20200404,MS,148,1873,2021,0.073231074
1989,20200403,MS,121,1654,1775,0.068169014
2045,20200402,MS,65,1654,1719,0.037812682
2101,20200401,MS,27,1324,1351,0.019985196
2157,20200331,MS,2193,1311,3504,0.625856164
2213,20200330,MS,2100,926,3026,0.693985459
2269,20200329,MS,2004,889,2893,0.692706533
2325,20200328,MS,1888,889,2777,0.679870364
2381,20200327,MS,1740,889,2629,0.661848612
2437,20200326,MS,1559,867,2426,0.642621599
2493,20200325,MS,1325,78,1403,0.944404847
2549,20200324,MS,1246,76,1322,0.942511346
2605,20200323,MS,935,18,953,0.981112277
2661,20200322,MS,836,15,851,0.982373678
2717,20200321,MS,480,2275,2755,0.174228675
2773,20200320,MS,2075,2275,4350,0.477011494
2829,20200319,MS,1670,2015,3685,0.453188602
2885,20200318,MS,1273,1825,3098,0.410910265
2941,20200317,MS,839,1533,2372,0.353709949
2997,20200316,MS,371,1211,1582,0.234513274
3050,20200315,MS,283,2519,2802,0.100999286
3101,20200314,MS,1758,2519,4277,0.411035773
3152,20200313,MS,1349,1685,3034,0.444627554
3203,20200312,MS,3,1685,1688,0.001777251
3253,20200311,MS,2,927,929,0.002152853
3303,20200310,MS,2,1,3,0.666666667
3353,20200309,MS,2,1,3,0.666666667
3403,20200308,MS,2,1,3,0.666666667
3453,20200307,MS,2,1,3,0.666666667
30,20200508,MT,1534,941,2475,0.61979798
86,20200507,MT,1532,818,2350,0.651914894
142,20200506,MT,1532,800,2332,0.656946827
198,20200505,MT,1532,514,2046,0.748778104
254,20200504,MT,1533,509,2042,0.750734574
310,20200503,MT,1531,502,2033,0.753074274
366,20200502,MT,1531,484,2015,0.759801489
422,20200501,MT,1530,432,1962,0.779816514
478,20200430,MT,1530,421,1951,0.784213224
534,20200429,MT,1528,405,1933,0.790481117
590,20200428,MT,1528,353,1881,0.812333865
646,20200427,MT,1520,344,1864,0.815450644
702,20200426,MT,1519,337,1856,0.818426724
758,20200425,MT,1517,319,1836,0.826252723
814,20200424,MT,1516,253,1769,0.856981345
870,20200423,MT,1515,243,1758,0.861774744
926,20200422,MT,1507,227,1734,0.869088812
982,20200421,MT,1506,161,1667,0.903419316
1038,20200420,MT,1504,150,1654,0.909310762
1094,20200419,MT,1504,142,1646,0.913730255
1150,20200418,MT,1491,125,1616,0.922648515
1206,20200417,MT,1488,2598,4086,0.364170338
1262,20200416,MT,1480,2581,4061,0.364442256
1318,20200415,MT,1468,2568,4036,0.363726462
1374,20200414,MT,1348,2480,3828,0.352142111
1430,20200413,MT,1345,2471,3816,0.352463312
1486,20200412,MT,1334,2461,3795,0.351515152
1542,20200411,MT,1325,2439,3764,0.352019129
1598,20200410,MT,1309,2323,3632,0.360407489
1654,20200409,MT,1295,2307,3602,0.359522488
1710,20200408,MT,1266,2279,3545,0.357122708
1766,20200407,MT,1235,2125,3360,0.367559524
1822,20200406,MT,1047,2117,3164,0.33091024
1878,20200405,MT,1020,2110,3130,0.325878594
1934,20200404,MT,978,1911,2889,0.338525441
1990,20200403,MT,928,1880,2808,0.33048433
2046,20200402,MT,888,1871,2759,0.321855745
2102,20200401,MT,837,1650,2487,0.33655006
2158,20200331,MT,599,1624,2223,0.269455691
2214,20200330,MT,570,1617,2187,0.260631001
2270,20200329,MT,518,1617,2135,0.242622951
2326,20200328,MT,412,1292,1704,0.241784038
2382,20200327,MT,331,894,1225,0.270204082
2438,20200326,MT,1973,856,2829,0.697419583
2494,20200325,MT,1699,112,1811,0.938155715
2550,20200324,MT,1535,87,1622,0.946362515
2606,20200323,MT,1273,19,1292,0.985294118
2662,20200322,MT,1219,19,1238,0.984652666
2718,20200321,MT,813,19,832,0.977163462
2774,20200320,MT,525,2640,3165,0.165876777
2830,20200319,MT,371,2401,2772,0.133838384
2886,20200318,MT,283,1862,2145,0.131934732
2942,20200317,MT,2025,1371,3396,0.596289753
2998,20200316,MT,1909,840,2749,0.69443434
3051,20200315,MT,1909,185,2094,0.91165234
3102,20200314,MT,1567,185,1752,0.894406393
3153,20200313,MT,3,2001,2004,0.001497006
3204,20200312,MT,3,1457,1460,0.002054795
3254,20200311,MT,2,966,968,0.002066116
3304,20200310,MT,2,551,553,0.003616637
3354,20200309,MT,2,219,221,0.009049774
3404,20200308,MT,2,219,221,0.009049774
3454,20200307,MT,2,219,221,0.009049774
31,20200508,NC,437,676,1113,0.392632525
87,20200507,NC,422,615,1037,0.406943105
143,20200506,NC,390,597,987,0.395136778
199,20200505,NC,378,473,851,0.444183314
255,20200504,NC,355,454,809,0.43881335
311,20200503,NC,351,448,799,0.439299124
367,20200502,NC,345,389,734,0.470027248
423,20200501,NC,319,372,691,0.461649783
479,20200430,NC,305,303,608,0.501644737
535,20200429,NC,2168,213,2381,0.910541789
591,20200428,NC,2153,187,2340,0.92008547
647,20200427,NC,2133,170,2303,0.926183239
703,20200426,NC,2063,2681,4744,0.434865093
759,20200425,NC,2053,2664,4717,0.435234259
815,20200424,NC,2028,2628,4656,0.43556701
871,20200423,NC,1941,2554,4495,0.431813126
927,20200422,NC,1923,2513,4436,0.433498647
983,20200421,NC,1828,2397,4225,0.432662722
1039,20200420,NC,1813,2355,4168,0.434980806
1095,20200419,NC,1792,2350,4142,0.432641236
1151,20200418,NC,1770,2327,4097,0.432023432
1207,20200417,NC,1656,2234,3890,0.425706941
1263,20200416,NC,1617,2212,3829,0.422303473
1319,20200415,NC,1582,2177,3759,0.420856611
1375,20200414,NC,1569,2147,3716,0.422228202
1431,20200413,NC,1442,2064,3506,0.411294923
1487,20200412,NC,1412,2046,3458,0.408328514
1543,20200411,NC,1386,2019,3405,0.407048458
1599,20200410,NC,1181,1978,3159,0.373852485
1655,20200409,NC,1147,1751,2898,0.3957902
1711,20200408,NC,1113,1598,2711,0.410549613
1767,20200407,NC,1084,1554,2638,0.410917362
1823,20200406,NC,793,1553,2346,0.338022165
1879,20200405,NC,746,1544,2290,0.325764192
1935,20200404,NC,713,1519,2232,0.319444444
1991,20200403,NC,654,1254,1908,0.342767296
2047,20200402,NC,250,1164,1414,0.176803395
2103,20200401,NC,177,1101,1278,0.138497653
2159,20200331,NC,158,988,1146,0.137870855
2215,20200330,NC,106,813,919,0.115342764
2271,20200329,NC,14,716,730,0.019178082
2327,20200328,NC,2192,644,2836,0.772919605
2383,20200327,NC,2007,493,2500,0.8028
2439,20200326,NC,1872,329,2201,0.85052249
2495,20200325,NC,1678,2610,4288,0.391324627
2551,20200324,NC,1347,2437,3784,0.355972516
2607,20200323,NC,1045,2437,3482,0.300114877
2663,20200322,NC,955,2103,3058,0.312295618
2719,20200321,NC,599,1870,2469,0.242608343
2775,20200320,NC,454,1281,1735,0.26167147
2831,20200319,NC,2208,880,3088,0.715025907
2887,20200318,NC,1867,101,1968,0.948678862
2943,20200317,NC,1462,1821,3283,0.445324398
2999,20200316,NC,1256,1270,2526,0.49722882
3052,20200315,NC,1236,1048,2284,0.541155867
3103,20200314,NC,892,464,1356,0.657817109
3154,20200313,NC,490,2535,3025,0.161983471
3205,20200312,NC,371,2145,2516,0.14745628
3255,20200311,NC,1909,1,1910,0.99947644
3305,20200310,NC,1909,1,1910,0.99947644
3355,20200309,NC,628,1,629,0.998410175
3405,20200308,NC,628,1,629,0.998410175
3455,20200307,NC,628,1,629,0.998410175
3496,20200306,NC,628,1,629,0.998410175
3524,20200305,NC,3,1,4,0.75
3545,20200304,NC,3,1,4,0.75
32,20200508,ND,138,1688,1826,0.075575027
88,20200507,ND,122,1593,1715,0.071137026
144,20200506,ND,110,1540,1650,0.066666667
200,20200505,ND,94,1488,1582,0.059418458
256,20200504,ND,78,1443,1521,0.051282051
312,20200503,ND,68,1407,1475,0.046101695
368,20200502,ND,54,1355,1409,0.038325053
424,20200501,ND,39,1225,1264,0.03085443
480,20200430,ND,24,1158,1182,0.020304569
536,20200429,ND,13,1094,1107,0.011743451
592,20200428,ND,2219,1036,3255,0.68172043
648,20200427,ND,2196,986,3182,0.690131992
704,20200426,ND,2111,819,2930,0.720477816
760,20200425,ND,2076,761,2837,0.7317589
816,20200424,ND,1995,649,2644,0.754538578
872,20200423,ND,1972,571,2543,0.775462053
928,20200422,ND,1894,520,2414,0.784589892
984,20200421,ND,1878,491,2369,0.792739553
1040,20200420,ND,1864,481,2345,0.794882729
1096,20200419,ND,1749,404,2153,0.812354854
1152,20200418,ND,1698,338,2036,0.833988212
1208,20200417,ND,1507,261,1768,0.852375566
1264,20200416,ND,1344,238,1582,0.849557522
1320,20200415,ND,1309,166,1475,0.887457627
1376,20200414,ND,1278,147,1425,0.896842105
1432,20200413,ND,1265,140,1405,0.900355872
1488,20200412,ND,1216,120,1336,0.910179641
1544,20200411,ND,1041,2595,3636,0.28630363
1600,20200410,ND,999,2577,3576,0.279362416
1656,20200409,ND,981,2473,3454,0.284018529
1712,20200408,ND,950,2446,3396,0.279740872
1768,20200407,ND,912,2303,3215,0.283670295
1824,20200406,ND,886,2144,3030,0.292409241
1880,20200405,ND,836,2121,2957,0.282718972
1936,20200404,ND,601,2090,2691,0.223337049
1992,20200403,ND,572,1899,2471,0.231485229
2048,20200402,ND,523,1658,2181,0.239798258
2104,20200401,ND,482,1629,2111,0.228327807
2160,20200331,ND,407,1616,2023,0.201186357
2216,20200330,ND,332,1326,1658,0.200241255
2272,20200329,ND,2210,1298,3508,0.629988597
2328,20200328,ND,2090,910,3000,0.696666667
2384,20200327,ND,1880,882,2762,0.680666184
2440,20200326,ND,1689,847,2536,0.666009464
2496,20200325,ND,1336,93,1429,0.934919524
2552,20200324,ND,1273,66,1339,0.950709485
2608,20200323,ND,1193,52,1245,0.958232932
2664,20200322,ND,1001,39,1040,0.9625
2720,20200321,ND,1001,17,1018,0.983300589
2776,20200320,ND,813,2494,3307,0.245842153
2832,20200319,ND,490,1858,2348,0.208688245
2888,20200318,ND,1758,1180,2938,0.598366236
2944,20200317,ND,1049,1041,2090,0.501913876
3000,20200316,ND,3,373,376,0.007978723
3053,20200315,ND,3,2650,2653,0.001130795
3104,20200314,ND,3,1984,1987,0.001509814
3155,20200313,ND,3,1582,1585,0.001892744
3206,20200312,ND,3,315,318,0.009433962
3256,20200311,ND,2,2276,2278,0.000877963
3306,20200310,ND,2,2089,2091,0.00095648
3356,20200309,ND,2,2,4,0.5
3406,20200308,ND,2,2,4,0.5
3456,20200307,ND,2,2,4,0.5
33,20200508,NE,1920,1434,3354,0.572450805
89,20200507,NE,1814,1367,3181,0.570260924
145,20200506,NE,1788,1259,3047,0.586806695
201,20200505,NE,1763,1228,2991,0.589434972
257,20200504,NE,1662,1201,2863,0.580509955
313,20200503,NE,1605,1140,2745,0.584699454
369,20200502,NE,1445,1095,2540,0.568897638
425,20200501,NE,1383,1055,2438,0.567268253
481,20200430,NE,1163,987,2150,0.540930233
537,20200429,NE,1107,935,2042,0.542115573
593,20200428,NE,1102,934,2036,0.541257367
649,20200427,NE,1054,804,1858,0.567276642
705,20200426,NE,767,756,1523,0.503611293
761,20200425,NE,717,703,1420,0.504929577
817,20200424,NE,660,639,1299,0.508083141
873,20200423,NE,241,569,810,0.297530864
929,20200422,NE,212,522,734,0.288828338
985,20200421,NE,190,510,700,0.271428571
1041,20200420,NE,152,486,638,0.238244514
1097,20200419,NE,101,414,515,0.196116505
1153,20200418,NE,49,341,390,0.125641026
1209,20200417,NE,23,318,341,0.06744868
1265,20200416,NE,2202,240,2442,0.901719902
1321,20200415,NE,2171,162,2333,0.930561509
1377,20200414,NE,2113,143,2256,0.936613475
1433,20200413,NE,2081,126,2207,0.942908926
1489,20200412,NE,2022,2603,4625,0.437189189
1545,20200411,NE,1968,2574,4542,0.4332893
1601,20200410,NE,1871,2472,4343,0.430808197
1657,20200409,NE,1733,2435,4168,0.415786948
1713,20200408,NE,1688,2301,3989,0.4231637
1769,20200407,NE,1518,2132,3650,0.415890411
1825,20200406,NE,1469,2115,3584,0.409877232
1881,20200405,NE,1307,1894,3201,0.408309903
1937,20200404,NE,1247,1868,3115,0.400321027
1993,20200403,NE,1000,1638,2638,0.379075057
2049,20200402,NE,931,1342,2273,0.409590849
2105,20200401,NE,855,1306,2161,0.395650162
2161,20200331,NE,571,920,1491,0.382964453
2217,20200330,NE,485,893,1378,0.351959361
2273,20200329,NE,331,115,446,0.742152466
2329,20200328,NE,2205,111,2316,0.952072539
2385,20200327,NE,2101,95,2196,0.956739526
2441,20200326,NE,1984,80,2064,0.96124031
2497,20200325,NE,1846,44,1890,0.976719577
2553,20200324,NE,1689,2673,4362,0.387207703
2609,20200323,NE,1670,1509,3179,0.525322428
2665,20200322,NE,1551,1509,3060,0.506862745
2721,20200321,NE,1327,1509,2836,0.467912553
2777,20200320,NE,1236,1108,2344,0.527303754
2833,20200319,NE,982,1108,2090,0.469856459
2889,20200318,NE,914,961,1875,0.487466667
2945,20200317,NE,839,961,1800,0.466111111
3001,20200316,NE,577,720,1297,0.444872783
3054,20200315,NE,553,2485,3038,0.18202765
3105,20200314,NE,457,2485,2942,0.155336506
3156,20200313,NE,413,2485,2898,0.142512077
3207,20200312,NE,283,2485,2768,0.102239884
3257,20200311,NE,1567,1806,3373,0.464571598
3307,20200310,NE,1049,1806,2855,0.367425569
3357,20200309,NE,1049,1514,2563,0.409285993
3407,20200308,NE,3,688,691,0.004341534
3457,20200307,NE,3,688,691,0.004341534
3497,20200306,NE,2,688,690,0.002898551
3525,20200305,NE,2,688,690,0.002898551
34,20200508,NH,790,1200,1990,0.396984925
90,20200507,NH,768,1152,1920,0.4
146,20200506,NH,752,1117,1869,0.4023542
202,20200505,NH,747,1089,1836,0.406862745
258,20200504,NH,747,1089,1836,0.406862745
314,20200503,NH,718,1141,1859,0.386229155
370,20200502,NH,692,1018,1710,0.404678363
426,20200501,NH,663,821,1484,0.446765499
482,20200430,NH,645,820,1465,0.440273038
538,20200429,NH,632,767,1399,0.451751251
594,20200428,NH,268,749,1017,0.263520157
650,20200427,NH,252,713,965,0.261139896
706,20200426,NH,231,658,889,0.25984252
762,20200425,NH,211,625,836,0.252392344
818,20200424,NH,197,555,752,0.261968085
874,20200423,NH,179,497,676,0.264792899
930,20200422,NH,156,424,580,0.268965517
986,20200421,NH,156,357,513,0.304093567
1042,20200420,NH,128,351,479,0.267223382
1098,20200419,NH,116,320,436,0.266055046
1154,20200418,NH,101,247,348,0.290229885
1210,20200417,NH,101,242,343,0.294460641
1266,20200416,NH,50,222,272,0.183823529
1322,20200415,NH,50,222,272,0.183823529
1378,20200414,NH,9,148,157,0.057324841
1434,20200413,NH,2212,131,2343,0.944088775
1490,20200412,NH,2190,2611,4801,0.456154968
1546,20200411,NH,2119,2584,4703,0.45056347
1602,20200410,NH,2084,2566,4650,0.448172043
1658,20200409,NH,2019,2475,4494,0.449265688
1714,20200408,NH,2019,2452,4471,0.451576828
1770,20200407,NH,1976,2431,4407,0.448377581
1826,20200406,NH,1890,2314,4204,0.449571836
1882,20200405,NH,1860,2300,4160,0.447115385
1938,20200404,NH,1712,2140,3852,0.444444444
1994,20200403,NH,1550,2119,3669,0.422458436
2050,20200402,NH,1480,2095,3575,0.413986014
2106,20200401,NH,1480,1916,3396,0.435806832
2162,20200331,NH,1230,1885,3115,0.394863563
2218,20200330,NH,1230,1883,3113,0.39511725
2274,20200329,NH,860,1640,2500,0.344
2330,20200328,NH,602,1320,1922,0.313215401
2386,20200327,NH,522,1300,1822,0.286498353
2442,20200326,NH,454,1275,1729,0.262579526
2498,20200325,NH,331,876,1207,0.274233637
2554,20200324,NH,322,64,386,0.834196891
2610,20200323,NH,2014,54,2068,0.973887814
2666,20200322,NH,1880,23,1903,0.98791382
2722,20200321,NH,1719,2672,4391,0.391482578
2778,20200320,NH,1508,2381,3889,0.38776035
2834,20200319,NH,1336,2180,3516,0.379977247
2890,20200318,NH,961,1945,2906,0.330695114
2946,20200317,NH,553,1508,2061,0.268316351
3002,20200316,NH,413,1206,1619,0.255095738
3055,20200315,NH,413,1206,1619,0.255095738
3106,20200314,NH,1909,1004,2913,0.655338139
3157,20200313,NH,1758,2643,4401,0.399454669
3208,20200312,NH,1758,2643,4401,0.399454669
3258,20200311,NH,1349,1563,2912,0.463255495
3308,20200310,NH,1349,1563,2912,0.463255495
3358,20200309,NH,1349,1563,2912,0.463255495
3408,20200308,NH,1349,1563,2912,0.463255495
3458,20200307,NH,628,927,1555,0.403858521
3498,20200306,NH,628,927,1555,0.403858521
3526,20200305,NH,628,623,1251,0.501998401
3546,20200304,NH,628,119,747,0.840696118
35,20200508,NJ,452,670,1122,0.40285205
91,20200507,NJ,449,621,1070,0.419626168
147,20200506,NJ,446,612,1058,0.421550095
203,20200505,NJ,443,612,1055,0.419905213
259,20200504,NJ,411,548,959,0.428571429
315,20200503,NJ,408,547,955,0.427225131
371,20200502,NJ,404,468,872,0.463302752
427,20200501,NJ,401,458,859,0.466821886
483,20200430,NJ,369,394,763,0.4836173
539,20200429,NJ,367,380,747,0.491298527
595,20200428,NJ,363,362,725,0.500689655
651,20200427,NJ,359,298,657,0.546423135
707,20200426,NJ,333,287,620,0.537096774
763,20200425,NJ,328,210,538,0.609665428
819,20200424,NJ,324,191,515,0.629126214
875,20200423,NJ,2217,168,2385,0.929559748
931,20200422,NJ,2200,2654,4854,0.453234446
987,20200421,NJ,2184,2626,4810,0.454054054
1043,20200420,NJ,2118,2558,4676,0.45295124
1099,20200419,NJ,2102,2532,4634,0.453603798
1155,20200418,NJ,2079,2499,4578,0.45412844
1211,20200417,NJ,2015,2422,4437,0.454135677
1267,20200416,NJ,1997,2398,4395,0.454379977
1323,20200415,NJ,1974,2358,4332,0.45567867
1379,20200414,NJ,1898,2333,4231,0.448593713
1435,20200413,NJ,1875,2199,4074,0.460235641
1491,20200412,NJ,1848,2199,4047,0.456634544
1547,20200411,NJ,1742,2173,3915,0.4449553
1603,20200410,NJ,1709,2068,3777,0.45247551
1659,20200409,NJ,1683,2020,3703,0.454496354
1715,20200408,NJ,1544,1963,3507,0.440262332
1771,20200407,NJ,1511,1928,3439,0.43937191
1827,20200406,NJ,1471,1818,3289,0.447248404
1883,20200405,NJ,1317,1759,3076,0.428153446
1939,20200404,NJ,1274,1691,2965,0.429679595
1995,20200403,NJ,1036,1549,2585,0.400773694
2051,20200402,NJ,944,1442,2386,0.395641241
2107,20200401,NJ,870,1354,2224,0.39118705
2163,20200331,NJ,588,1184,1772,0.331828442
2219,20200330,NJ,538,1124,1662,0.323706378
2275,20200329,NJ,421,1023,1444,0.291551247
2331,20200328,NJ,338,806,1144,0.295454545
2387,20200327,NJ,2062,641,2703,0.762856086
2443,20200326,NJ,1821,429,2250,0.809333333
2499,20200325,NJ,1398,141,1539,0.908382066
2555,20200324,NJ,1149,2449,3598,0.31934408
2611,20200323,NJ,791,1511,2302,0.343614248
2667,20200322,NJ,262,1428,1690,0.155029586
2723,20200321,NJ,112,1268,1380,0.08115942
2779,20200320,NJ,2124,1173,3297,0.64422202
2835,20200319,NJ,1992,1001,2993,0.665552957
2891,20200318,NJ,1492,823,2315,0.644492441
2947,20200317,NJ,979,669,1648,0.594053398
3003,20200316,NJ,575,361,936,0.614316239
3056,20200315,NJ,2210,361,2571,0.859587709
3107,20200314,NJ,1670,2669,4339,0.384881309
3158,20200313,NJ,1670,2669,4339,0.384881309
3209,20200312,NJ,1193,2373,3566,0.334548514
3259,20200311,NJ,914,2034,2948,0.310040706
3309,20200310,NJ,490,1746,2236,0.219141324
3359,20200309,NJ,334,1485,1819,0.183617372
3409,20200308,NJ,1758,1376,3134,0.56094448
3459,20200307,NJ,1349,1,1350,0.999259259
3499,20200306,NJ,3,1,4,0.75
3527,20200305,NJ,3,1,4,0.75
36,20200508,NM,1406,2524,3930,0.357760814
92,20200507,NM,1384,2500,3884,0.356333677
148,20200506,NM,1366,2425,3791,0.36032709
204,20200505,NM,1353,2408,3761,0.359744749
260,20200504,NM,1174,2374,3548,0.330890643
316,20200503,NM,1155,2339,3494,0.330566686
372,20200502,NM,1125,2239,3364,0.334423306
428,20200501,NM,1112,2197,3309,0.336053188
484,20200430,NM,1083,2167,3250,0.333230769
540,20200429,NM,810,2066,2876,0.281641168
596,20200428,NM,786,2013,2799,0.280814577
652,20200427,NM,766,1979,2745,0.279052823
708,20200426,NM,756,1938,2694,0.280623608
764,20200425,NM,731,1843,2574,0.283993784
820,20200424,NM,710,1752,2462,0.288383428
876,20200423,NM,674,1583,2257,0.298626495
932,20200422,NM,651,1577,2228,0.292190305
988,20200421,NM,276,1527,1803,0.153078203
1044,20200420,NM,247,1490,1737,0.142199194
1100,20200419,NM,236,1475,1711,0.137931034
1156,20200418,NM,210,1449,1659,0.126582278
1212,20200417,NM,180,1416,1596,0.112781955
1268,20200416,NM,155,1394,1549,0.100064558
1324,20200415,NM,132,1383,1515,0.087128713
1380,20200414,NM,117,1360,1477,0.079214624
1436,20200413,NM,87,1252,1339,0.064973861
1492,20200412,NM,64,1197,1261,0.05075337
1548,20200411,NM,34,1150,1184,0.028716216
1604,20200410,NM,34,1150,1184,0.028716216
1660,20200409,NM,2109,1039,3148,0.669949174
1716,20200408,NM,2023,984,3007,0.672763552
1772,20200407,NM,1901,971,2872,0.661908078
1828,20200406,NM,1861,757,2618,0.710847976
1884,20200405,NM,1714,630,2344,0.731228669
1940,20200404,NM,1564,554,2118,0.738432483
1996,20200403,NM,1467,494,1961,0.74808771
2052,20200402,NM,1307,428,1735,0.753314121
2108,20200401,NM,1231,359,1590,0.774213836
2164,20200331,NM,1015,326,1341,0.756897837
2220,20200330,NM,912,165,1077,0.846796657
2276,20200329,NM,912,159,1071,0.851540616
2332,20200328,NM,622,2570,3192,0.194862155
2388,20200327,NM,453,2451,2904,0.155991736
2444,20200326,NM,360,2311,2671,0.134780981
2500,20200325,NM,321,2130,2451,0.130966952
2556,20200324,NM,2090,1910,4000,0.5225
2612,20200323,NM,1880,1879,3759,0.500133014
2668,20200322,NM,1734,1652,3386,0.512108683
2724,20200321,NM,1734,1331,3065,0.565742251
2780,20200320,NM,1495,1331,2826,0.529016277
2836,20200319,NM,1285,907,2192,0.586222628
2892,20200318,NM,1001,874,1875,0.533866667
2948,20200317,NM,892,37,929,0.960172228
3004,20200316,NM,553,2031,2584,0.214009288
3057,20200315,NM,413,1844,2257,0.182986265
3108,20200314,NM,283,1083,1366,0.207174231
3159,20200313,NM,283,823,1106,0.255877034
3210,20200312,NM,1567,607,2174,0.720791168
3260,20200311,NM,1049,2542,3591,0.292119187
3310,20200310,NM,2,2257,2259,0.000885347
3360,20200309,NM,2,2034,2036,0.000982318
3410,20200308,NM,2,1826,1828,0.001094092
3460,20200307,NM,2,1826,1828,0.001094092
3500,20200306,NM,2,623,625,0.0032
37,20200508,NV,1660,1810,3470,0.478386167
93,20200507,NV,1645,1775,3420,0.480994152
149,20200506,NV,1635,1733,3368,0.485451306
205,20200505,NV,1628,1709,3337,0.48786335
261,20200504,NV,1622,1677,3299,0.491664141
317,20200503,NV,1610,1605,3215,0.500777605
373,20200502,NV,1602,1585,3187,0.502667085
429,20200501,NV,1591,1571,3162,0.503162555
485,20200430,NV,1461,1530,2991,0.488465396
541,20200429,NV,1453,1517,2970,0.489225589
597,20200428,NV,1441,1492,2933,0.49130583
653,20200427,NV,1430,1458,2888,0.495152355
709,20200426,NV,1419,1444,2863,0.49563395
765,20200425,NV,1414,1413,2827,0.500176866
821,20200424,NV,1397,1390,2787,0.501255831
877,20200423,NV,1377,1358,2735,0.503473492
933,20200422,NV,1360,1262,2622,0.518688024
989,20200421,NV,1185,1246,2431,0.487453723
1045,20200420,NV,1171,1227,2398,0.488323603
1101,20200419,NV,1154,1202,2356,0.489813243
1157,20200418,NV,1143,1186,2329,0.49076857
1213,20200417,NV,1126,1155,2281,0.493643139
1269,20200416,NV,1095,1120,2215,0.494356659
1325,20200415,NV,1082,1092,2174,0.497700092
1381,20200414,NV,1064,1063,2127,0.500235073
1437,20200413,NV,809,1030,1839,0.439912996
1493,20200412,NV,788,994,1782,0.442199776
1549,20200411,NV,762,949,1711,0.445353594
1605,20200410,NV,745,931,1676,0.44451074
1661,20200409,NV,722,803,1525,0.473442623
1717,20200408,NV,695,752,1447,0.480304077
1773,20200407,NV,653,643,1296,0.503858025
1829,20200406,NV,270,574,844,0.319905213
1885,20200405,NV,243,523,766,0.317232376
1941,20200404,NV,221,496,717,0.308228731
1997,20200403,NV,160,400,560,0.285714286
2053,20200402,NV,149,345,494,0.301619433
2109,20200401,NV,99,245,344,0.287790698
2165,20200331,NV,41,153,194,0.211340206
2221,20200330,NV,5,130,135,0.037037037
2277,20200329,NV,1990,2453,4443,0.447895566
2333,20200328,NV,1860,2322,4182,0.444763271
2389,20200327,NV,1703,2101,3804,0.447686646
2445,20200326,NV,1486,1648,3134,0.474154435
2501,20200325,NV,1247,1625,2872,0.434192201
2557,20200324,NV,999,1339,2338,0.427288281
2613,20200323,NV,930,1309,2239,0.415364002
2669,20200322,NV,621,884,1505,0.412624585
2725,20200321,NV,405,878,1283,0.315666407
2781,20200320,NV,332,117,449,0.739420935
2837,20200319,NV,2199,85,2284,0.962784588
2893,20200318,NV,1719,682,2401,0.715951687
2949,20200317,NV,1719,682,2401,0.715951687
3005,20200316,NV,1521,682,2203,0.690422152
3058,20200315,NV,839,682,1521,0.551610782
3109,20200314,NV,813,682,1495,0.543812709
3160,20200313,NV,334,682,1016,0.328740157
3211,20200312,NV,1909,682,2591,0.736781166
3261,20200311,NV,1567,682,2249,0.696754113
3311,20200310,NV,3,475,478,0.006276151
3361,20200309,NV,3,475,478,0.006276151
3411,20200308,NV,3,475,478,0.006276151
3461,20200307,NV,3,475,478,0.006276151
3501,20200306,NV,3,475,478,0.006276151
3528,20200305,NV,3,475,478,0.006276151
38,20200508,NY,1264,2429,3693,0.342269158
94,20200507,NY,1254,2403,3657,0.34290402
150,20200506,NY,1250,2369,3619,0.345399282
206,20200505,NY,1248,2337,3585,0.348117155
262,20200504,NY,1234,2255,3489,0.353683004
318,20200503,NY,1233,2231,3464,0.355946882
374,20200502,NY,1228,2202,3430,0.358017493
430,20200501,NY,1217,2171,3388,0.359208973
486,20200430,NY,1214,2088,3302,0.367655966
542,20200429,NY,1048,2054,3102,0.337846551
598,20200428,NY,1043,2000,3043,0.342753861
654,20200427,NY,1040,1982,3022,0.344142952
710,20200426,NY,1023,1946,2969,0.344560458
766,20200425,NY,1017,1861,2878,0.353370396
822,20200424,NY,995,1784,2779,0.358042461
878,20200423,NY,976,1744,2720,0.358823529
934,20200422,NY,958,1702,2660,0.360150376
990,20200421,NY,951,1609,2560,0.371484375
1046,20200420,NY,933,1581,2514,0.371121718
1102,20200419,NY,927,1559,2486,0.372888174
1158,20200418,NY,911,1513,2424,0.375825083
1214,20200417,NY,891,1479,2370,0.375949367
1270,20200416,NY,884,1429,2313,0.382187635
1326,20200415,NY,859,1399,2258,0.380425155
1382,20200414,NY,832,1271,2103,0.395625297
1438,20200413,NY,625,1239,1864,0.335300429
1494,20200412,NY,603,1208,1811,0.332965213
1550,20200411,NY,595,1170,1765,0.337110482
1606,20200410,NY,569,1114,1683,0.33808675
1662,20200409,NY,524,1077,1601,0.32729544
1718,20200408,NY,489,1010,1499,0.326217478
1774,20200407,NY,456,953,1409,0.323633783
1830,20200406,NY,444,824,1268,0.350157729
1886,20200405,NY,402,776,1178,0.341256367
1942,20200404,NY,362,687,1049,0.345090562
1998,20200403,NY,325,614,939,0.346112886
2054,20200402,NY,2183,541,2724,0.801395007
2110,20200401,NY,2091,465,2556,0.818075117
2166,20200331,NY,1999,396,2395,0.834655532
2222,20200330,NY,1887,314,2201,0.857337574
2278,20200329,NY,1753,281,2034,0.861848574
2334,20200328,NY,1691,189,1880,0.899468085
2390,20200327,NY,1512,174,1686,0.896797153
2446,20200326,NY,1314,2527,3841,0.342098412
2502,20200325,NY,1205,2353,3558,0.338673412
2558,20200324,NY,946,2213,3159,0.299461855
2614,20200323,NY,827,2042,2869,0.288253747
2670,20200322,NY,495,1791,2286,0.216535433
2726,20200321,NY,299,1487,1786,0.167413214
2782,20200320,NY,1914,1127,3041,0.629398224
2838,20200319,NY,1368,746,2114,0.647114475
2894,20200318,NY,711,325,1036,0.686293436
2950,20200317,NY,206,1890,2096,0.098282443
3006,20200316,NY,2201,1641,3842,0.572878709
3059,20200315,NY,1983,1641,3624,0.54718543
3110,20200314,NY,1696,908,2604,0.651305684
3161,20200313,NY,1487,908,2395,0.620876827
3212,20200312,NY,862,2624,3486,0.247274814
3262,20200311,NY,862,2624,3486,0.247274814
3312,20200310,NY,572,2624,3196,0.178973717
3362,20200309,NY,482,2624,3106,0.155183516
3412,20200308,NY,327,2624,2951,0.110809895
3462,20200307,NY,2006,2624,4630,0.433261339
3502,20200306,NY,1256,2624,3880,0.32371134
3529,20200305,NY,866,2394,3260,0.265644172
3547,20200304,NY,1758,1826,3584,0.490513393
39,20200508,OH,893,664,1557,0.573538857
95,20200507,OH,868,603,1471,0.590074779
151,20200506,OH,848,543,1391,0.609633357
207,20200505,OH,829,474,1303,0.636224098
263,20200504,OH,819,455,1274,0.642857143
319,20200503,OH,618,442,1060,0.583018868
375,20200502,OH,609,384,993,0.613293051
431,20200501,OH,589,366,955,0.616753927
487,20200430,OH,578,294,872,0.662844037
543,20200429,OH,557,275,832,0.669471154
599,20200428,OH,526,200,726,0.724517906
655,20200427,OH,506,190,696,0.727011494
711,20200426,OH,514,169,683,0.752562225
767,20200425,OH,503,2663,3166,0.158875553
823,20200424,OH,496,2627,3123,0.158821646
879,20200423,OH,471,2553,3024,0.155753968
935,20200422,OH,460,2522,2982,0.154258887
991,20200421,OH,434,2493,2927,0.148274684
1047,20200420,OH,394,2409,2803,0.140563682
1103,20200419,OH,349,2388,2737,0.127511874
1159,20200418,OH,294,2250,2544,0.115566038
1215,20200417,OH,2132,2250,4382,0.486535828
1271,20200416,OH,2043,2220,4263,0.479239972
1327,20200415,OH,1953,2186,4139,0.471853105
1383,20200414,OH,1927,2155,4082,0.472072513
1439,20200413,OH,1831,2061,3892,0.47045221
1495,20200412,OH,1803,2027,3830,0.47075718
1551,20200411,OH,1776,1985,3761,0.472214836
1607,20200410,OH,1658,1957,3615,0.458644537
1663,20200409,OH,1624,1926,3550,0.457464789
1719,20200408,OH,1585,1831,3416,0.463992974
1775,20200407,OH,1439,1788,3227,0.445925008
1831,20200406,OH,1404,1741,3145,0.446422893
1887,20200405,OH,1356,1600,2956,0.458728011
1943,20200404,OH,1158,1567,2725,0.424954128
1999,20200403,OH,1092,1486,2578,0.423584174
2055,20200402,OH,798,1405,2203,0.362233318
2111,20200401,OH,736,1168,1904,0.386554622
2167,20200331,OH,672,1168,1840,0.365217391
2223,20200330,OH,267,1129,1396,0.191260745
2279,20200329,OH,192,795,987,0.194528875
2335,20200328,OH,131,795,926,0.141468683
2391,20200327,OH,48,795,843,0.056939502
2447,20200326,OH,2111,637,2748,0.768195051
2503,20200325,OH,1970,477,2447,0.80506743
2559,20200324,OH,1730,524,2254,0.767524401
2615,20200323,OH,1515,524,2039,0.74301128
2671,20200322,OH,1293,524,1817,0.711612548
2727,20200321,OH,932,524,1456,0.64010989
2783,20200320,OH,552,524,1076,0.513011152
2839,20200319,OH,370,524,894,0.413870246
2895,20200318,OH,2117,524,2641,0.801590307
2951,20200317,OH,1891,524,2415,0.783022774
3007,20200316,OH,1670,524,2194,0.761166819
3060,20200315,OH,1300,471,1771,0.73404856
3111,20200314,OH,413,1917,2330,0.177253219
3162,20200313,OH,413,1917,2330,0.177253219
3213,20200312,OH,1567,1344,2911,0.538302989
3263,20200311,OH,1349,966,2315,0.582721382
3313,20200310,OH,1049,475,1524,0.68832021
3363,20200309,OH,1049,219,1268,0.827287066
3413,20200308,OH,2,119,121,0.016528926
3463,20200307,OH,2,2561,2563,0.000780336
3503,20200306,OH,2,2430,2432,0.000822368
3530,20200305,OH,2,2276,2278,0.000877963
40,20200508,OK,1400,2533,3933,0.35596237
96,20200507,OK,1388,2510,3898,0.356080041
152,20200506,OK,1376,2418,3794,0.362677912
208,20200505,OK,1365,2385,3750,0.364
264,20200504,OK,1357,2082,3439,0.394591451
320,20200503,OK,1189,2082,3271,0.363497401
376,20200502,OK,1175,2082,3257,0.360761437
432,20200501,OK,1159,2082,3241,0.357605677
488,20200430,OK,1141,2082,3223,0.354017996
544,20200429,OK,1121,2050,3171,0.353516241
600,20200428,OK,1111,2023,3134,0.354499043
656,20200427,OK,1089,1855,2944,0.369904891
712,20200426,OK,1086,1855,2941,0.369262156
768,20200425,OK,1078,1855,2933,0.367541766
824,20200424,OK,1068,1721,2789,0.382932951
880,20200423,OK,1051,1721,2772,0.379148629
936,20200422,OK,797,1721,2518,0.316521048
992,20200421,OK,784,1694,2478,0.316384181
1048,20200420,OK,760,1420,2180,0.348623853
1104,20200419,OK,748,1420,2168,0.34501845
1160,20200418,OK,740,1420,2160,0.342592593
1216,20200417,OK,723,1380,2103,0.343794579
1272,20200416,OK,704,1229,1933,0.364200724
1328,20200415,OK,684,1167,1851,0.369529984
1384,20200414,OK,670,1153,1823,0.367526056
1440,20200413,OK,649,946,1595,0.406896552
1496,20200412,OK,275,946,1221,0.225225225
1552,20200411,OK,254,946,1200,0.211666667
1608,20200410,OK,233,938,1171,0.198975235
1664,20200409,OK,201,762,963,0.208722741
1720,20200408,OK,162,258,420,0.385714286
1776,20200407,OK,151,258,409,0.369193154
1832,20200406,OK,112,59,171,0.65497076
1888,20200405,OK,92,57,149,0.617449664
1944,20200404,OK,57,53,110,0.518181818
2000,20200403,OK,2214,48,2262,0.978779841
2056,20200402,OK,2116,41,2157,0.980992119
2112,20200401,OK,1977,36,2013,0.982116244
2168,20200331,OK,1731,34,1765,0.980736544
2224,20200330,OK,1556,30,1586,0.981084489
2280,20200329,OK,1494,29,1523,0.980958634
2336,20200328,OK,1325,21,1346,0.984398217
2392,20200327,OK,1249,11,1260,0.991269841
2448,20200326,OK,934,2660,3594,0.259877574
2504,20200325,OK,548,2495,3043,0.180085442
2560,20200324,OK,329,2371,2700,0.121851852
2616,20200323,OK,2078,2274,4352,0.477481618
2672,20200322,OK,1891,2230,4121,0.458869207
2728,20200321,OK,1699,2028,3727,0.455862624
2784,20200320,OK,1562,1983,3545,0.440620592
2840,20200319,OK,1508,1805,3313,0.455176577
2896,20200318,OK,1024,1562,2586,0.395978345
2952,20200317,OK,553,1113,1666,0.331932773
3008,20200316,OK,283,730,1013,0.279368213
3061,20200315,OK,2128,305,2433,0.874640362
3112,20200314,OK,1349,1514,2863,0.471184073
3163,20200313,OK,1049,1514,2563,0.409285993
3214,20200312,OK,1049,1514,2563,0.409285993
3264,20200311,OK,628,551,1179,0.532654792
3314,20200310,OK,628,551,1179,0.532654792
3364,20200309,OK,3,2430,2433,0.001233046
3414,20200308,OK,3,2430,2433,0.001233046
3464,20200307,OK,3,1,4,0.75
41,20200508,OR,1061,2265,3326,0.319001804
97,20200507,OR,812,2237,3049,0.266316825
153,20200506,OR,801,2205,3006,0.266467066
209,20200505,OR,789,2176,2965,0.266104553
265,20200504,OR,775,2154,2929,0.264595425
321,20200503,OR,760,2076,2836,0.267983075
377,20200502,OR,751,2044,2795,0.268694097
433,20200501,OR,744,2012,2756,0.269956459
489,20200430,OR,729,1975,2704,0.269600592
545,20200429,OR,720,1951,2671,0.269561962
601,20200428,OR,701,1841,2542,0.275767113
657,20200427,OR,701,1841,2542,0.275767113
713,20200426,OR,693,1798,2491,0.278201525
769,20200425,OR,682,1769,2451,0.278253774
825,20200424,OR,668,1727,2395,0.278914405
881,20200423,OR,661,1698,2359,0.280203476
937,20200422,OR,647,1586,2233,0.289744738
993,20200421,OR,630,1586,2216,0.284296029
1049,20200420,OR,272,1566,1838,0.147986942
1105,20200419,OR,260,1536,1796,0.144766147
1161,20200418,OR,246,1498,1744,0.141055046
1217,20200417,OR,229,1464,1693,0.135262847
1273,20200416,OR,218,1433,1651,0.132041187
1329,20200415,OR,195,1385,1580,0.123417722
1385,20200414,OR,187,1361,1548,0.120801034
1441,20200413,OR,177,1256,1433,0.123517097
1497,20200412,OR,164,1221,1385,0.118411552
1553,20200411,OR,122,1139,1261,0.096748612
1609,20200410,OR,109,1090,1199,0.090909091
1665,20200409,OR,109,1090,1199,0.090909091
1721,20200408,OR,84,1060,1144,0.073426573
1777,20200407,OR,66,997,1063,0.062088429
1833,20200406,OR,46,944,990,0.046464646
1889,20200405,OR,25,812,837,0.029868578
1945,20200404,OR,2222,640,2862,0.776380154
2001,20200403,OR,2127,640,2767,0.768702566
2057,20200402,OR,2088,561,2649,0.788221971
2113,20200401,OR,1989,407,2396,0.830133556
2169,20200331,OR,1905,407,2312,0.823961938
2225,20200330,OR,1843,330,2173,0.848136217
2281,20200329,OR,1717,163,1880,0.913297872
2337,20200328,OR,1550,2592,4142,0.374215355
2393,20200327,OR,1479,2459,3938,0.375571356
2449,20200326,OR,1253,2139,3392,0.369398585
2505,20200325,OR,838,1628,2466,0.339821573
2561,20200324,OR,838,1628,2466,0.339821573
2617,20200323,OR,622,1319,1941,0.320453375
2673,20200322,OR,545,914,1459,0.373543523
2729,20200321,OR,364,843,1207,0.301574151
2785,20200320,OR,364,843,1207,0.301574151
2841,20200319,OR,2117,50,2167,0.976926627
2897,20200318,OR,1996,16,2012,0.992047714
2953,20200317,OR,1543,2256,3799,0.406159516
3009,20200316,OR,1336,2057,3393,0.393751842
3062,20200315,OR,1300,1715,3015,0.431177446
3113,20200314,OR,1193,1456,2649,0.450358626
3164,20200313,OR,1193,1456,2649,0.450358626
3215,20200312,OR,605,1240,1845,0.327913279
3265,20200311,OR,605,1240,1845,0.327913279
3315,20200310,OR,490,1005,1495,0.327759197
3365,20200309,OR,457,677,1134,0.402998236
3415,20200308,OR,457,167,624,0.732371795
3465,20200307,OR,1909,2405,4314,0.442512749
3504,20200306,OR,1049,2190,3239,0.323865391
3531,20200305,OR,1049,1767,2816,0.372514205
3548,20200304,OR,1049,1243,2292,0.457678883
42,20200508,PA,1708,1011,2719,0.628172122
98,20200507,PA,1692,965,2657,0.636808431
154,20200506,PA,1684,957,2641,0.637637259
210,20200505,PA,1674,841,2515,0.665606362
266,20200504,PA,1671,833,2504,0.667332268
322,20200503,PA,1563,827,2390,0.653974895
378,20200502,PA,1553,788,2341,0.663391713
434,20200501,PA,1538,777,2315,0.664362851
490,20200430,PA,1525,733,2258,0.675376439
546,20200429,PA,1509,722,2231,0.676378306
602,20200428,PA,1498,678,2176,0.688419118
658,20200427,PA,1483,665,2148,0.690409683
714,20200426,PA,1473,613,2086,0.706136146
770,20200425,PA,1463,601,2064,0.708817829
826,20200424,PA,1330,544,1874,0.709711846
882,20200423,PA,1312,529,1841,0.712656165
938,20200422,PA,1292,461,1753,0.737022248
994,20200421,PA,1276,450,1726,0.739281576
1050,20200420,PA,1259,397,1656,0.7602657
1106,20200419,PA,1240,385,1625,0.763076923
1162,20200418,PA,1220,371,1591,0.766813325
1218,20200417,PA,1033,304,1337,0.77262528
1274,20200416,PA,994,285,1279,0.777169664
1330,20200415,PA,968,272,1240,0.780645161
1386,20200414,PA,940,212,1152,0.815972222
1442,20200413,PA,916,197,1113,0.823000898
1498,20200412,PA,881,181,1062,0.829566855
1554,20200411,PA,849,2676,3525,0.240851064
1610,20200410,PA,620,2636,3256,0.19041769
1666,20200409,PA,579,2545,3124,0.185339309
1722,20200408,PA,529,2509,3038,0.174127716
1778,20200407,PA,468,2399,2867,0.163236833
1834,20200406,PA,397,2332,2729,0.145474533
1890,20200405,PA,346,2217,2563,0.134998049
1946,20200404,PA,285,2146,2431,0.117235705
2002,20200403,PA,2044,1977,4021,0.508331261
2058,20200402,PA,1910,1813,3723,0.513027129
2114,20200401,PA,1649,1711,3360,0.49077381
2170,20200331,PA,1446,1550,2996,0.482643525
2226,20200330,PA,1361,1447,2808,0.48468661
2282,20200329,PA,1110,1347,2457,0.451770452
2338,20200328,PA,772,1125,1897,0.406958355
2394,20200327,PA,678,967,1645,0.412158055
2450,20200326,PA,203,636,839,0.241954708
2506,20200325,PA,45,230,275,0.163636364
2562,20200324,PA,2103,2465,4568,0.460376532
2618,20200323,PA,1878,2122,4000,0.4695
2674,20200322,PA,1550,1666,3216,0.481965174
2730,20200321,PA,1321,1329,2650,0.498490566
2786,20200320,PA,980,891,1871,0.523784073
2842,20200319,PA,600,83,683,0.878477306
2898,20200318,PA,448,22,470,0.953191489
2954,20200317,PA,2205,2549,4754,0.463819941
3010,20200316,PA,2006,2240,4246,0.472444654
3063,20200315,PA,1867,958,2825,0.660884956
3114,20200314,PA,1543,958,2501,0.616953219
3165,20200313,PA,1470,524,1994,0.737211635
3216,20200312,PA,866,295,1161,0.745908699
3266,20200311,PA,525,2550,3075,0.170731707
3316,20200310,PA,371,1,372,0.997311828
3366,20200309,PA,283,1,284,0.996478873
3416,20200308,PA,1758,1,1759,0.999431495
3466,20200307,PA,1349,1,1350,0.999259259
3505,20200306,PA,628,1,629,0.998410175
43,20200508,PR,665,1,666,0.998498498
99,20200507,PR,638,1,639,0.998435055
155,20200506,PR,274,1,275,0.996363636
211,20200505,PR,266,2575,2841,0.093629004
267,20200504,PR,245,2575,2820,0.086879433
323,20200503,PR,239,2575,2814,0.08493248
379,20200502,PR,223,2575,2798,0.079699786
435,20200501,PR,174,2575,2749,0.063295744
491,20200430,PR,168,2575,2743,0.06124681
547,20200429,PR,144,2575,2719,0.052960647
603,20200428,PR,130,2575,2705,0.04805915
659,20200427,PR,127,2575,2702,0.047002221
715,20200426,PR,122,2575,2697,0.045235447
771,20200425,PR,106,2575,2681,0.039537486
827,20200424,PR,98,2575,2673,0.036662926
883,20200423,PR,2179,2575,4754,0.458350862
939,20200422,PR,2179,2481,4660,0.467596567
995,20200421,PR,105,2479,2584,0.040634675
1051,20200420,PR,92,2458,2550,0.036078431
1107,20200419,PR,76,2445,2521,0.030146767
1163,20200418,PR,42,2433,2475,0.016969697
1219,20200417,PR,25,2320,2345,0.010660981
1275,20200416,PR,15,2294,2309,0.006496319
1331,20200415,PR,2209,2133,4342,0.508751727
1387,20200414,PR,2186,2108,4294,0.509082441
1443,20200413,PR,2173,1915,4088,0.531555773
1499,20200412,PR,2126,1905,4031,0.527412553
1555,20200411,PR,2019,1897,3916,0.51557712
1611,20200410,PR,1981,1872,3853,0.514144822
1667,20200409,PR,1900,1649,3549,0.535362074
1723,20200408,PR,1859,1626,3485,0.533428981
1779,20200407,PR,1735,1341,3076,0.564044213
1835,20200406,PR,1686,1302,2988,0.564257028
1891,20200405,PR,1548,1280,2828,0.54738331
1947,20200404,PR,1529,896,2425,0.630515464
2003,20200403,PR,1326,849,2175,0.609655172
2059,20200402,PR,1232,82,1314,0.937595129
2115,20200401,PR,1020,58,1078,0.94619666
2171,20200331,PR,913,24,937,0.974386339
2227,20200330,PR,573,2640,3213,0.178338002
2283,20200329,PR,409,2528,2937,0.139257746
2339,20200328,PR,321,2372,2693,0.119197921
2395,20200327,PR,2021,1947,3968,0.509324597
2451,20200326,PR,1873,1561,3434,0.545428072
2507,20200325,PR,1682,1403,3085,0.545218801
2563,20200324,PR,1336,1180,2516,0.53100159
2619,20200323,PR,1219,792,2011,0.606166087
2675,20200322,PR,892,782,1674,0.532855436
2731,20200321,PR,839,532,1371,0.611962071
2787,20200320,PR,457,286,743,0.615074024
2843,20200319,PR,1567,2018,3585,0.437099024
2899,20200318,PR,1567,1376,2943,0.532449881
2955,20200317,PR,1567,398,1965,0.797455471
3011,20200316,PR,1567,2561,4128,0.379602713
44,20200508,RI,314,2377,2691,0.116685247
100,20200507,RI,307,2342,2649,0.11589279
156,20200506,RI,293,2261,2554,0.114722005
212,20200505,RI,2165,2223,4388,0.493391067
268,20200504,RI,2157,2198,4355,0.495292767
324,20200503,RI,2149,2175,4324,0.496993525
380,20200502,RI,2142,2153,4295,0.498719441
436,20200501,RI,2073,2048,4121,0.503033244
492,20200430,RI,2052,2003,4055,0.506041924
548,20200429,RI,2036,1944,3980,0.511557789
604,20200428,RI,1960,1853,3813,0.514030947
660,20200427,RI,1949,1830,3779,0.515744906
716,20200426,RI,1935,1778,3713,0.521141934
772,20200425,RI,1915,1737,3652,0.524370208
828,20200424,RI,1809,1675,3484,0.519230769
884,20200423,RI,1778,1568,3346,0.531380753
940,20200422,RI,1655,1500,3155,0.524564184
996,20200421,RI,1618,1448,3066,0.527723418
1052,20200420,RI,1578,1396,2974,0.530598521
1108,20200419,RI,1437,1265,2702,0.531828275
1164,20200418,RI,1405,1223,2628,0.534627093
1220,20200417,RI,1373,1161,2534,0.541831097
1276,20200416,RI,1172,1088,2260,0.518584071
1332,20200415,RI,1129,1025,2154,0.524141133
1388,20200414,RI,1085,815,1900,0.571052632
1444,20200413,RI,811,710,1521,0.533201841
1500,20200412,RI,757,710,1467,0.516019087
1556,20200411,RI,699,587,1286,0.543545879
1612,20200410,RI,635,331,966,0.657349896
1668,20200409,RI,213,154,367,0.580381471
1724,20200408,RI,146,154,300,0.486666667
1780,20200407,RI,80,2562,2642,0.030280091
1836,20200406,RI,31,2297,2328,0.013316151
1892,20200405,RI,2185,2107,4292,0.509086673
1948,20200404,RI,2077,1898,3975,0.522515723
2004,20200403,RI,1972,1663,3635,0.542503439
2060,20200402,RI,1883,1634,3517,0.535399488
2116,20200401,RI,1732,1334,3066,0.564905414
2172,20200331,RI,1561,1307,2868,0.544281729
2228,20200330,RI,1466,1288,2754,0.53231663
2284,20200329,RI,1042,912,1954,0.533265097
2340,20200328,RI,913,887,1800,0.507222222
2396,20200327,RI,833,869,1702,0.489424207
2452,20200326,RI,549,40,589,0.932088285
2508,20200325,RI,447,40,487,0.917864476
2564,20200324,RI,405,26,431,0.939675174
2620,20200323,RI,329,18,347,0.948126801
2676,20200322,RI,2090,2641,4731,0.441767068
2732,20200321,RI,1885,2541,4426,0.425892454
2788,20200320,RI,1707,2494,4201,0.406331826
2844,20200319,RI,1508,2215,3723,0.405049691
2900,20200318,RI,1256,1997,3253,0.386105134
2956,20200317,RI,892,1681,2573,0.346677031
3012,20200316,RI,839,1373,2212,0.379294756
3064,20200315,RI,813,1206,2019,0.402674591
3115,20200314,RI,813,840,1653,0.491833031
3166,20200313,RI,457,528,985,0.463959391
3217,20200312,RI,1567,2643,4210,0.372209026
3267,20200311,RI,1567,2643,4210,0.372209026
3317,20200310,RI,1049,2058,3107,0.337624718
3367,20200309,RI,1049,1344,2393,0.438361889
3417,20200308,RI,1049,1344,2393,0.438361889
3467,20200307,RI,628,1344,1972,0.318458418
3506,20200306,RI,1049,688,1737,0.603914796
3532,20200305,RI,628,688,1316,0.477203647
3549,20200304,RI,628,219,847,0.741440378
3555,20200303,RI,628,2089,2717,0.231137284
3558,20200302,RI,3,1,4,0.75
3561,20200301,RI,3,1,4,0.75
45,20200508,SC,1916,2219,4135,0.463361548
101,20200507,SC,1826,2328,4154,0.439576312
157,20200506,SC,1826,2328,4154,0.439576312
213,20200505,SC,1811,2159,3970,0.456171285
269,20200504,SC,1805,2045,3850,0.468831169
325,20200503,SC,1805,2045,3850,0.468831169
381,20200502,SC,1791,2004,3795,0.471936759
437,20200501,SC,1777,1969,3746,0.474372664
493,20200430,SC,1765,1921,3686,0.47883885
549,20200429,SC,1659,1835,3494,0.474813967
605,20200428,SC,1631,1795,3426,0.476065382
661,20200427,SC,1621,1771,3392,0.477889151
717,20200426,SC,1621,1771,3392,0.477889151
773,20200425,SC,1596,1736,3332,0.478991597
829,20200424,SC,1455,1595,3050,0.47704918
885,20200423,SC,1455,1595,3050,0.47704918
941,20200422,SC,1438,1570,3008,0.478058511
997,20200421,SC,1401,1528,2929,0.478320246
1053,20200420,SC,1395,1516,2911,0.479216764
1109,20200419,SC,1395,1516,2911,0.479216764
1165,20200418,SC,1381,1467,2848,0.484901685
1221,20200417,SC,1184,1411,2595,0.456262042
1277,20200416,SC,1148,1379,2527,0.454293629
1333,20200415,SC,1148,1379,2527,0.454293629
1389,20200414,SC,1132,1352,2484,0.455716586
1445,20200413,SC,1094,1216,2310,0.473593074
1501,20200412,SC,1094,1216,2310,0.473593074
1557,20200411,SC,1081,1165,2246,0.481300089
1613,20200410,SC,1059,1118,2177,0.486449242
1669,20200409,SC,781,1097,1878,0.415867945
1725,20200408,SC,737,1019,1756,0.419703872
1781,20200407,SC,716,979,1695,0.422418879
1837,20200406,SC,643,656,1299,0.494996151
1893,20200405,SC,643,656,1299,0.494996151
1949,20200404,SC,264,633,897,0.294314381
2005,20200403,SC,171,1886,2057,0.083130773
2061,20200402,SC,171,1886,2057,0.083130773
2117,20200401,SC,104,1867,1971,0.052765094
2173,20200331,SC,32,1645,1677,0.019081694
2229,20200330,SC,2188,1618,3806,0.574881766
2285,20200329,SC,2012,1277,3289,0.61173609
2341,20200328,SC,1706,880,2586,0.65970611
2397,20200327,SC,1532,870,2402,0.637801832
2453,20200326,SC,1532,870,2402,0.637801832
2509,20200325,SC,1490,868,2358,0.631891433
2565,20200324,SC,1046,845,1891,0.553146483
2621,20200323,SC,1046,68,1114,0.938958707
2677,20200322,SC,624,68,692,0.901734104
2733,20200321,SC,517,38,555,0.931531532
2789,20200320,SC,2078,2518,4596,0.452132289
2845,20200319,SC,1834,2069,3903,0.469894953
2901,20200318,SC,1834,2069,3903,0.469894953
2957,20200317,SC,1256,1398,2654,0.473247928
3013,20200316,SC,1001,1081,2082,0.480787704
3065,20200315,SC,605,605,1210,0.5
3116,20200314,SC,413,267,680,0.607352941
3167,20200313,SC,371,2383,2754,0.134713145
3218,20200312,SC,283,1826,2109,0.134186818
3268,20200311,SC,2128,1404,3532,0.602491506
3318,20200310,SC,1909,1086,2995,0.637395659
3368,20200309,SC,1909,1086,2995,0.637395659
3418,20200308,SC,628,2430,3058,0.205362982
3468,20200307,SC,628,2430,3058,0.205362982
3507,20200306,SC,2,1863,1865,0.001072386
3533,20200305,SC,2,1863,1865,0.001072386
3550,20200304,SC,2,1863,1865,0.001072386
46,20200508,SD,1071,748,1819,0.588785047
102,20200507,SD,799,694,1493,0.535164099
158,20200506,SD,779,647,1426,0.54628331
214,20200505,SD,764,632,1396,0.547277937
270,20200504,SD,759,627,1386,0.547619048
326,20200503,SD,750,582,1332,0.563063063
382,20200502,SD,747,568,1315,0.568060837
438,20200501,SD,733,515,1248,0.587339744
494,20200430,SD,721,506,1227,0.587612062
550,20200429,SD,709,498,1207,0.587406794
606,20200428,SD,694,490,1184,0.586148649
662,20200427,SD,681,483,1164,0.585051546
718,20200426,SD,676,478,1154,0.585788562
774,20200425,SD,664,418,1082,0.613678373
830,20200424,SD,640,354,994,0.643863179
886,20200423,SD,272,322,594,0.457912458
942,20200422,SD,251,249,500,0.502
998,20200421,SD,222,223,445,0.498876404
1054,20200420,SD,202,151,353,0.57223796
1110,20200419,SD,188,139,327,0.574923547
1166,20200418,SD,169,124,293,0.576791809
1222,20200417,SD,134,2589,2723,0.04921043
1278,20200416,SD,108,2572,2680,0.040298507
1334,20200415,SD,59,2469,2528,0.023338608
1390,20200414,SD,2214,2447,4661,0.475005364
1446,20200413,SD,2112,2436,4548,0.464379947
1502,20200412,SD,1987,2317,4304,0.461663569
1558,20200411,SD,1863,2296,4159,0.447944217
1614,20200410,SD,1704,2282,3986,0.427496237
1670,20200409,SD,1518,2128,3646,0.416346681
1726,20200408,SD,1344,2113,3457,0.388776396
1782,20200407,SD,1246,1912,3158,0.394553515
1838,20200406,SD,1022,1903,2925,0.349401709
1894,20200405,SD,926,1881,2807,0.329889562
1950,20200404,SD,857,1864,2721,0.314957736
2006,20200403,SD,602,1644,2246,0.268032057
2062,20200402,SD,549,1623,2172,0.252762431
2118,20200401,SD,412,1336,1748,0.235697941
2174,20200331,SD,331,1317,1648,0.200849515
2230,20200330,SD,322,1308,1630,0.197546012
2286,20200329,SD,2169,1284,3453,0.628149435
2342,20200328,SD,1895,895,2790,0.67921147
2398,20200327,SD,1741,879,2620,0.664503817
2454,20200326,SD,1535,116,1651,0.929739552
2510,20200325,SD,1470,2505,3975,0.369811321
2566,20200324,SD,1193,2428,3621,0.329466998
2622,20200323,SD,1001,2402,3403,0.294152219
2678,20200322,SD,839,2380,3219,0.26063995
2734,20200321,SD,457,2271,2728,0.167521994
2790,20200320,SD,457,2229,2686,0.170141474
2846,20200319,SD,334,2014,2348,0.142248722
2902,20200318,SD,334,2014,2348,0.142248722
2958,20200317,SD,334,2014,2348,0.142248722
3014,20200316,SD,283,1859,2142,0.132119514
3066,20200315,SD,2128,1428,3556,0.598425197
3117,20200314,SD,2128,781,2909,0.73152286
3168,20200313,SD,2128,2360,4488,0.474153298
3219,20200312,SD,2025,1182,3207,0.631431244
3269,20200311,SD,1567,398,1965,0.797455471
3319,20200310,SD,2,219,221,0.009049774
3369,20200309,SD,2,1863,1865,0.001072386
3419,20200308,SD,2,1863,1865,0.001072386
3469,20200307,SD,2,1863,1865,0.001072386
47,20200508,TN,467,1051,1518,0.307641634
103,20200507,TN,459,1045,1504,0.30518617
159,20200506,TN,440,1006,1446,0.30428769
215,20200505,TN,433,959,1392,0.311063218
271,20200504,TN,429,839,1268,0.338328076
327,20200503,TN,416,828,1244,0.334405145
383,20200502,TN,389,783,1172,0.331911263
439,20200501,TN,358,731,1089,0.328741965
495,20200430,TN,313,681,994,0.314889336
551,20200429,TN,301,617,918,0.32788671
607,20200428,TN,287,598,885,0.324293785
663,20200427,TN,2164,534,2698,0.802075612
719,20200426,TN,2158,467,2625,0.822095238
775,20200425,TN,2136,449,2585,0.826305609
831,20200424,TN,2059,369,2428,0.848023064
887,20200423,TN,2038,289,2327,0.875805758
943,20200422,TN,1956,204,2160,0.905555556
999,20200421,TN,1930,171,2101,0.918610186
1055,20200420,TN,1925,2637,4562,0.421964051
1111,20200419,TN,1913,2613,4526,0.422669023
1167,20200418,TN,1812,2516,4328,0.418669131
1223,20200417,TN,1802,2491,4293,0.419753086
1279,20200416,TN,1778,2420,4198,0.423535017
1335,20200415,TN,1761,2379,4140,0.425362319
1391,20200414,TN,1652,2361,4013,0.411662098
1447,20200413,TN,1630,2329,3959,0.411720131
1503,20200412,TN,1601,2209,3810,0.420209974
1559,20200411,TN,1580,2165,3745,0.421895861
1615,20200410,TN,1449,2053,3502,0.413763564
1671,20200409,TN,1421,2008,3429,0.414406533
1727,20200408,TN,1392,1953,3345,0.416143498
1783,20200407,TN,1366,1840,3206,0.426076107
1839,20200406,TN,1166,1732,2898,0.402346446
1895,20200405,TN,1144,1697,2841,0.402675114
1951,20200404,TN,1095,1565,2660,0.411654135
2007,20200403,TN,1060,1473,2533,0.418476115
2063,20200402,TN,792,1388,2180,0.363302752
2119,20200401,TN,761,1260,2021,0.376546264
2175,20200331,TN,680,1119,1799,0.377987771
2231,20200330,TN,242,985,1227,0.197229014
2287,20200329,TN,167,796,963,0.173416407
2343,20200328,TN,123,659,782,0.157289003
2399,20200327,TN,70,518,588,0.119047619
2455,20200326,TN,2204,440,2644,0.833585477
2511,20200325,TN,2016,220,2236,0.901610018
2567,20200324,TN,1889,144,2033,0.929168716
2623,20200323,TN,1852,1294,3146,0.588684043
2679,20200322,TN,1679,1294,2973,0.564749411
2735,20200321,TN,1321,1294,2615,0.505162524
2791,20200320,TN,889,2030,2919,0.304556355
2847,20200319,TN,518,1484,2002,0.258741259
2903,20200318,TN,2210,1484,3694,0.598267461
2959,20200317,TN,1984,1451,3435,0.577583697
3015,20200316,TN,1689,1205,2894,0.583621285
3067,20200315,TN,1336,611,1947,0.686183873
3118,20200314,TN,1236,441,1677,0.737030411
3169,20200313,TN,961,295,1256,0.765127389
3220,20200312,TN,577,2424,3001,0.192269244
3270,20200311,TN,1909,1917,3826,0.498954522
3320,20200310,TN,1909,1,1910,0.99947644
3370,20200309,TN,1049,1,1050,0.999047619
3420,20200308,TN,1049,1,1050,0.999047619
3470,20200307,TN,3,1,4,0.75
3508,20200306,TN,3,1,4,0.75
3534,20200305,TN,3,1,4,0.75
48,20200508,TX,1302,1761,3063,0.425073457
104,20200507,TX,1289,1704,2993,0.430671567
160,20200506,TX,1275,1682,2957,0.43118025
216,20200505,TX,1261,1608,2869,0.439525967
272,20200504,TX,1241,1560,2801,0.443056051
328,20200503,TX,1225,1512,2737,0.447570332
384,20200502,TX,1200,1504,2704,0.443786982
440,20200501,TX,1027,1422,2449,0.419354839
496,20200430,TX,1004,1369,2373,0.423093131
552,20200429,TX,984,1242,2226,0.442048518
608,20200428,TX,964,1210,2174,0.443422263
664,20200427,TX,939,1175,2114,0.444181646
720,20200426,TX,923,1144,2067,0.446540881
776,20200425,TX,902,1084,1986,0.454179255
832,20200424,TX,880,1015,1895,0.464379947
888,20200423,TX,853,955,1808,0.471792035
944,20200422,TX,842,834,1676,0.502386635
1000,20200421,TX,816,786,1602,0.509363296
1056,20200420,TX,611,723,1334,0.45802099
1112,20200419,TX,593,672,1265,0.468774704
1168,20200418,TX,580,616,1196,0.484949833
1224,20200417,TX,559,599,1158,0.482728843
1280,20200416,TX,534,530,1064,0.501879699
1336,20200415,TX,502,462,964,0.520746888
1392,20200414,TX,469,445,914,0.513129103
1448,20200413,TX,439,309,748,0.586898396
1504,20200412,TX,425,271,696,0.610632184
1560,20200411,TX,388,208,596,0.651006711
1616,20200410,TX,352,194,546,0.644688645
1672,20200409,TX,295,2655,2950,0.1
1728,20200408,TX,2145,2540,4685,0.457844184
1784,20200407,TX,2037,2488,4525,0.450165746
1840,20200406,TX,1926,2414,4340,0.443778802
1896,20200405,TX,1815,2191,4006,0.453070394
1952,20200404,TX,1766,2047,3813,0.463152373
2008,20200403,TX,1606,1922,3528,0.45521542
2064,20200402,TX,1427,1787,3214,0.443995022
2120,20200401,TX,1192,1739,2931,0.406687137
2176,20200331,TX,1088,1601,2689,0.40461138
2232,20200330,TX,794,1431,2225,0.356853933
2288,20200329,TX,737,1057,1794,0.410813824
2344,20200328,TX,644,1057,1701,0.378600823
2400,20200327,TX,215,1000,1215,0.176954733
2456,20200326,TX,129,928,1057,0.122043519
2512,20200325,TX,2209,340,2549,0.866614359
2568,20200324,TX,1477,158,1635,0.903363914
2624,20200323,TX,1294,2593,3887,0.332904554
2680,20200322,TX,1267,2454,3721,0.340499866
2736,20200321,TX,1213,2105,3318,0.365581676
2792,20200320,TX,623,1869,2492,0.25
2848,20200319,TX,483,862,1345,0.359107807
2904,20200318,TX,2090,103,2193,0.953032376
2960,20200317,TX,1873,28,1901,0.98527091
3016,20200316,TX,1734,1,1735,0.999423631
3068,20200315,TX,1725,1,1726,0.999420626
3119,20200314,TX,1682,1,1683,0.999405823
3170,20200313,TX,1336,1,1337,0.999252057
3221,20200312,TX,892,1,893,0.998880179
3271,20200311,TX,839,1,840,0.998809524
3321,20200310,TX,413,1,414,0.997584541
3371,20200309,TX,371,1,372,0.997311828
3421,20200308,TX,2025,1,2026,0.999506417
3471,20200307,TX,2025,1,2026,0.999506417
3509,20200306,TX,1567,1,1568,0.999362245
3535,20200305,TX,3,1,4,0.75
3551,20200304,TX,3,1,4,0.75
49,20200508,UT,1664,451,2115,0.786761229
105,20200507,UT,1641,390,2031,0.807976366
161,20200506,UT,1629,381,2010,0.810447761
217,20200505,UT,1613,364,1977,0.81588265
273,20200504,UT,1603,310,1913,0.837950863
329,20200503,UT,1589,300,1889,0.841185813
385,20200502,UT,1460,280,1740,0.83908046
441,20200501,UT,1443,207,1650,0.874545455
497,20200430,UT,1428,192,1620,0.881481481
553,20200429,UT,1407,177,1584,0.888257576
609,20200428,UT,1389,2674,4063,0.341865617
665,20200427,UT,1378,2656,4034,0.34159643
721,20200426,UT,1364,2621,3985,0.342283563
777,20200425,UT,1186,2538,3724,0.318474758
833,20200424,UT,1162,2492,3654,0.318007663
889,20200423,UT,1140,2406,3546,0.321489002
945,20200422,UT,1118,2362,3480,0.321264368
1001,20200421,UT,1090,2258,3348,0.325567503
1057,20200420,UT,1083,2206,3289,0.329279416
1113,20200419,UT,1062,2151,3213,0.330532213
1169,20200418,UT,803,2036,2839,0.282846073
1225,20200417,UT,783,1962,2745,0.285245902
1281,20200416,UT,761,1802,2563,0.296917675
1337,20200415,UT,735,1768,2503,0.293647623
1393,20200414,UT,715,1748,2463,0.290296387
1449,20200413,UT,705,1731,2436,0.289408867
1505,20200412,UT,690,1699,2389,0.288823776
1561,20200411,UT,673,1673,2346,0.28687127
1617,20200410,UT,655,1575,2230,0.293721973
1673,20200409,UT,277,1521,1798,0.154060067
1729,20200408,UT,248,1462,1710,0.14502924
1785,20200407,UT,219,1417,1636,0.133863081
1841,20200406,UT,199,1386,1585,0.12555205
1897,20200405,UT,182,1253,1435,0.126829268
1953,20200404,UT,141,1162,1303,0.108211819
2009,20200403,UT,88,1053,1141,0.077125329
2065,20200402,UT,28,930,958,0.029227557
2121,20200401,UT,6,930,936,0.006410256
2177,20200331,UT,2121,707,2828,0.75
2233,20200330,UT,2077,557,2634,0.788534548
2289,20200329,UT,1977,413,2390,0.827196653
2345,20200328,UT,1839,156,1995,0.921804511
2401,20200327,UT,1555,2476,4031,0.385760357
2457,20200326,UT,1466,2293,3759,0.38999734
2513,20200325,UT,1282,2117,3399,0.377169756
2569,20200324,UT,1047,1891,2938,0.356364874
2625,20200323,UT,957,1656,2613,0.366245695
2681,20200322,UT,596,1310,1906,0.312696747
2737,20200321,UT,453,881,1334,0.33958021
2793,20200320,UT,360,846,1206,0.298507463
2849,20200319,UT,2014,65,2079,0.968734969
2905,20200318,UT,1867,444,2311,0.807875379
2961,20200317,UT,1682,444,2126,0.791157103
3017,20200316,UT,1336,444,1780,0.750561798
3069,20200315,UT,1001,444,1445,0.692733564
3120,20200314,UT,1758,444,2202,0.798365123
3171,20200313,UT,1758,444,2202,0.798365123
3222,20200312,UT,1349,444,1793,0.752370329
3272,20200311,UT,628,1,629,0.998410175
3322,20200310,UT,628,1,629,0.998410175
3372,20200309,UT,3,1,4,0.75
3422,20200308,UT,3,1,4,0.75
3472,20200307,UT,3,1,4,0.75
50,20200508,VA,871,206,1077,0.808727948
106,20200507,VA,847,178,1025,0.826341463
162,20200506,VA,817,2638,3455,0.236468886
218,20200505,VA,817,2638,3455,0.236468886
274,20200504,VA,614,2631,3245,0.189214176
330,20200503,VA,587,2559,3146,0.186586141
386,20200502,VA,564,2521,3085,0.182820097
442,20200501,VA,541,2560,3101,0.174459852
498,20200430,VA,509,2387,2896,0.175759669
554,20200429,VA,478,2334,2812,0.169985775
610,20200428,VA,465,2252,2717,0.171144645
666,20200427,VA,427,2235,2662,0.16040571
722,20200426,VA,396,2184,2580,0.153488372
778,20200425,VA,382,2148,2530,0.150988142
834,20200424,VA,348,2051,2399,0.145060442
890,20200423,VA,320,1980,2300,0.139130435
946,20200422,VA,296,1927,2223,0.133153396
1002,20200421,VA,2156,1839,3995,0.539674593
1058,20200420,VA,2074,1815,3889,0.533299049
1114,20200419,VA,2048,1789,3837,0.533750326
1170,20200418,VA,2029,1740,3769,0.538339082
1226,20200417,VA,1938,1693,3631,0.533737262
1282,20200416,VA,1822,1596,3418,0.533060269
1338,20200415,VA,1794,1551,3345,0.53632287
1394,20200414,VA,1773,1524,3297,0.537761601
1450,20200413,VA,1644,1497,3141,0.523400191
1506,20200412,VA,1597,1472,3069,0.52036494
1562,20200411,VA,1576,1418,2994,0.526386106
1618,20200410,VA,1410,1366,2776,0.507925072
1674,20200409,VA,1355,1236,2591,0.522964107
1730,20200408,VA,1146,1183,2329,0.492056677
1786,20200407,VA,1098,1126,2224,0.493705036
1842,20200406,VA,795,989,1784,0.445627803
1898,20200405,VA,753,968,1721,0.437536316
1954,20200404,VA,714,797,1511,0.472534745
2010,20200403,VA,633,662,1295,0.488803089
2066,20200402,VA,208,588,796,0.261306533
2122,20200401,VA,155,435,590,0.262711864
2178,20200331,VA,91,323,414,0.219806763
2234,20200330,VA,9,221,230,0.039130435
2290,20200329,VA,2124,2594,4718,0.450190759
2346,20200328,VA,1991,2455,4446,0.447818264
2402,20200327,VA,1841,2129,3970,0.46372796
2458,20200326,VA,1539,1902,3441,0.447253705
2514,20200325,VA,1343,1667,3010,0.446179402
2570,20200324,VA,1039,1620,2659,0.390748402
2626,20200323,VA,954,1303,2257,0.42268498
2682,20200322,VA,865,1283,2148,0.402700186
2738,20200321,VA,517,897,1414,0.36562942
2794,20200320,VA,364,861,1225,0.297142857
2850,20200319,VA,2195,104,2299,0.95476294
2906,20200318,VA,2009,27,2036,0.986738703
2962,20200317,VA,1891,2667,4558,0.414874945
3018,20200316,VA,1682,1745,3427,0.490808287
3070,20200315,VA,1521,1531,3052,0.49836173
3121,20200314,VA,1193,301,1494,0.798527443
3172,20200313,VA,1193,301,1494,0.798527443
3223,20200312,VA,553,301,854,0.647540984
3273,20200311,VA,2128,2145,4273,0.498010765
3323,20200310,VA,2025,1966,3991,0.507391631
3373,20200309,VA,1049,1563,2612,0.401607963
3423,20200308,VA,628,1514,2142,0.29318394
3473,20200307,VA,2,1376,1378,0.001451379
3510,20200306,VA,2,966,968,0.002066116
3536,20200305,VA,2,739,741,0.002699055
51,20200508,VI,1895,4,1899,0.997893628
107,20200507,VI,1885,2687,4572,0.412292213
163,20200506,VI,1885,2687,4572,0.412292213
219,20200505,VI,1885,2672,4557,0.413649331
275,20200504,VI,1885,2668,4553,0.414012739
331,20200503,VI,1885,2657,4542,0.415015412
387,20200502,VI,1885,2632,4517,0.417312375
443,20200501,VI,1885,2503,4388,0.429580675
499,20200430,VI,1885,2496,4381,0.430267062
555,20200429,VI,1856,2370,4226,0.439185991
611,20200428,VI,1752,2348,4100,0.427317073
667,20200427,VI,1752,2347,4099,0.427421322
723,20200426,VI,1734,2335,4069,0.426148931
779,20200425,VI,1719,2273,3992,0.430611222
835,20200424,VI,1707,2200,3907,0.436908114
891,20200423,VI,1707,2069,3776,0.452065678
947,20200422,VI,1707,2069,3776,0.452065678
1003,20200421,VI,1707,2055,3762,0.453748006
1059,20200420,VI,1699,2016,3715,0.457335128
1115,20200419,VI,1699,1999,3698,0.459437534
1171,20200418,VI,1699,1606,3305,0.514069592
1227,20200417,VI,1682,1558,3240,0.519135802
1283,20200416,VI,1682,1510,3192,0.526942356
1339,20200415,VI,1682,1452,3134,0.53669432
1395,20200414,VI,1682,1427,3109,0.541009971
1451,20200413,VI,1682,1421,3103,0.542056075
1507,20200412,VI,1682,1273,2955,0.569204738
1563,20200411,VI,1682,1273,2955,0.569204738
1619,20200410,VI,1670,1209,2879,0.580062522
1675,20200409,VI,1535,1143,2678,0.573188947
1731,20200408,VI,1521,1110,2631,0.578107184
1787,20200407,VI,1495,1044,2539,0.588814494
1843,20200406,VI,1495,1044,2539,0.588814494
1899,20200405,VI,1482,961,2443,0.606631191
1955,20200404,VI,1462,784,2246,0.650934996
2011,20200403,VI,1327,605,1932,0.686853002
2067,20200402,VI,1256,549,1805,0.695844875
2123,20200401,VI,1193,383,1576,0.756979695
2179,20200331,VI,1193,383,1576,0.756979695
2235,20200330,VI,1193,383,1576,0.756979695
2291,20200329,VI,892,373,1265,0.70513834
2347,20200328,VI,866,198,1064,0.813909774
2403,20200327,VI,605,2001,2606,0.232156562
2459,20200326,VI,553,2001,2554,0.216523101
2515,20200325,VI,553,2001,2554,0.216523101
2571,20200324,VI,553,1,554,0.998194946
2627,20200323,VI,553,1,554,0.998194946
2683,20200322,VI,1758,1,1759,0.999431495
2739,20200321,VI,1758,1,1759,0.999431495
2795,20200320,VI,1049,1,1050,0.999047619
2851,20200319,VI,1049,1,1050,0.999047619
2907,20200318,VI,628,1,629,0.998410175
2963,20200317,VI,628,1,629,0.998410175
3019,20200316,VI,3,1,4,0.75
52,20200508,VT,2182,745,2927,0.745473181
108,20200507,VT,2180,702,2882,0.756419153
164,20200506,VT,2175,660,2835,0.767195767
220,20200505,VT,2174,646,2820,0.770921986
276,20200504,VT,2172,635,2807,0.773779836
332,20200503,VT,2126,628,2754,0.771968046
388,20200502,VT,2120,576,2696,0.786350148
444,20200501,VT,2116,564,2680,0.789552239
500,20200430,VT,2110,513,2623,0.804422417
556,20200429,VT,2107,504,2611,0.806970509
612,20200428,VT,2107,492,2599,0.810696422
668,20200427,VT,2104,487,2591,0.812041683
724,20200426,VT,2103,439,2542,0.827301338
780,20200425,VT,2098,434,2532,0.828593997
836,20200424,VT,2089,422,2511,0.831939466
892,20200423,VT,2087,401,2488,0.838826367
948,20200422,VT,2086,347,2433,0.857377723
1004,20200421,VT,2083,332,2415,0.86252588
1060,20200420,VT,2082,324,2406,0.865336658
1116,20200419,VT,2080,262,2342,0.888129804
1172,20200418,VT,2076,256,2332,0.890222985
1228,20200417,VT,2013,239,2252,0.893872114
1284,20200416,VT,2008,157,2165,0.927482679
1340,20200415,VT,2005,135,2140,0.936915888
1396,20200414,VT,2000,2599,4599,0.434877147
1452,20200413,VT,1995,2585,4580,0.43558952
1508,20200412,VT,1982,2563,4545,0.436083608
1564,20200411,VT,1975,2462,4437,0.445120577
1620,20200410,VT,1894,2309,4203,0.450630502
1676,20200409,VT,1865,2309,4174,0.446813608
1732,20200408,VT,1842,2283,4125,0.446545455
1788,20200407,VT,1737,2118,3855,0.450583658
1844,20200406,VT,1714,2097,3811,0.449750722
1900,20200405,VT,1685,2093,3778,0.446003176
1956,20200404,VT,1540,1882,3422,0.450029223
2012,20200403,VT,1335,1660,2995,0.445742905
2068,20200402,VT,1271,1651,2922,0.434976044
2124,20200401,VT,1247,1619,2866,0.435101186
2180,20200331,VT,1041,1340,2381,0.437211256
2236,20200330,VT,956,1322,2278,0.419666374
2292,20200329,VT,910,1305,2215,0.410835214
2348,20200328,VT,856,857,1713,0.499708114
2404,20200327,VT,599,851,1450,0.413103448
2460,20200326,VT,522,107,629,0.829888712
2516,20200325,VT,403,81,484,0.832644628
2572,20200324,VT,2199,63,2262,0.972148541
2628,20200323,VT,1996,13,2009,0.993529119
2684,20200322,VT,1689,13,1702,0.992361927
2740,20200321,VT,1024,2412,3436,0.298020955
2796,20200320,VT,1024,2412,3436,0.298020955
2852,20200319,VT,866,2201,3067,0.282360613
2908,20200318,VT,605,2086,2691,0.224823486
2964,20200317,VT,283,1860,2143,0.132057863
3020,20200316,VT,2025,1716,3741,0.541299118
3071,20200315,VT,1349,1482,2831,0.476510067
3122,20200314,VT,1349,1048,2397,0.562786817
3173,20200313,VT,628,528,1156,0.543252595
3224,20200312,VT,628,2669,3297,0.19047619
3274,20200311,VT,3,2172,2175,0.00137931
3324,20200310,VT,3,1670,1673,0.001793186
3374,20200309,VT,3,1457,1460,0.002054795
3424,20200308,VT,3,1213,1216,0.002467105
3474,20200307,VT,2,623,625,0.0032
3511,20200306,VT,2,2430,2432,0.000822368
53,20200508,WA,528,1009,1537,0.34352635
109,20200507,WA,512,964,1476,0.346883469
165,20200506,WA,504,956,1460,0.345205479
221,20200505,WA,501,951,1452,0.345041322
277,20200504,WA,497,837,1334,0.372563718
333,20200503,WA,491,830,1321,0.371688115
389,20200502,WA,470,785,1255,0.374501992
445,20200501,WA,463,738,1201,0.385512073
501,20200430,WA,458,729,1187,0.385846672
557,20200429,WA,436,684,1120,0.389285714
613,20200428,WA,432,679,1111,0.388838884
669,20200427,WA,426,668,1094,0.389396709
725,20200426,WA,426,667,1093,0.389752973
781,20200425,WA,426,667,1093,0.389752973
837,20200424,WA,417,666,1083,0.385041551
893,20200423,WA,398,620,1018,0.390962672
949,20200422,WA,391,608,999,0.391391391
1005,20200421,WA,387,595,982,0.394093686
1061,20200420,WA,381,539,920,0.414130435
1117,20200419,WA,375,531,906,0.413907285
1173,20200418,WA,357,525,882,0.404761905
1229,20200417,WA,353,469,822,0.429440389
1285,20200416,WA,342,456,798,0.428571429
1341,20200415,WA,336,443,779,0.431322208
1397,20200414,WA,316,386,702,0.45014245
1453,20200413,WA,310,374,684,0.453216374
1509,20200412,WA,302,311,613,0.492659054
1565,20200411,WA,292,306,598,0.488294314
1621,20200410,WA,2166,297,2463,0.879415347
1677,20200409,WA,2151,279,2430,0.885185185
1733,20200408,WA,2138,214,2352,0.909013605
1789,20200407,WA,2064,196,2260,0.913274336
1845,20200406,WA,2046,2685,4731,0.432466709
1901,20200405,WA,2032,2652,4684,0.43381725
1957,20200404,WA,1954,2639,4593,0.425430002
2013,20200403,WA,1931,2619,4550,0.424395604
2069,20200402,WA,1823,2539,4362,0.417927556
2125,20200401,WA,1800,2510,4310,0.417633411
2181,20200331,WA,1760,2417,4177,0.42135504
2237,20200330,WA,1627,2375,4002,0.406546727
2293,20200329,WA,1581,2269,3850,0.410649351
2349,20200328,WA,1435,2245,3680,0.389945652
2405,20200327,WA,1385,2214,3599,0.384829119
2461,20200326,WA,1169,2169,3338,0.350209706
2517,20200325,WA,1099,2052,3151,0.348778166
2573,20200324,WA,794,1974,2768,0.286849711
2629,20200323,WA,728,1837,2565,0.283820663
2685,20200322,WA,688,1734,2422,0.284062758
2741,20200321,WA,641,1700,2341,0.273814609
2797,20200320,WA,238,1604,1842,0.129207383
2853,20200319,WA,172,1515,1687,0.101956135
2909,20200318,WA,137,1392,1529,0.089601046
2965,20200317,WA,85,1192,1277,0.066562255
3021,20200316,WA,24,1040,1064,0.022556391
3072,20200315,WA,2194,754,2948,0.744233379
3123,20200314,WA,2077,653,2730,0.760805861
3174,20200313,WA,1969,507,2476,0.795234249
3225,20200312,WA,1720,146,1866,0.921757771
3275,20200311,WA,1556,2142,3698,0.420767983
3325,20200310,WA,1346,1662,3008,0.447473404
3375,20200309,WA,1284,1286,2570,0.499610895
3425,20200308,WA,935,860,1795,0.520891365
3475,20200307,WA,597,94,691,0.863965268
3512,20200306,WA,515,55,570,0.903508772
3537,20200305,WA,2208,2647,4855,0.454788877
3552,20200304,WA,2006,2188,4194,0.478302337
3556,20200303,WA,1741,1717,3458,0.503470214
3559,20200302,WA,1273,1050,2323,0.547998278
3562,20200301,WA,1193,2497,3690,0.323306233
3563,20200229,WA,577,1052,1629,0.354205034
3564,20200228,WA,2128,1,2129,0.999530296
3565,20200227,WA,628,1,629,0.998410175
3566,20200226,WA,628,1,629,0.998410175
3567,20200225,WA,628,1,629,0.998410175
3568,20200224,WA,628,1,629,0.998410175
3569,20200223,WA,628,1,629,0.998410175
3570,20200222,WA,628,1,629,0.998410175
3571,20200221,WA,628,1,629,0.998410175
3572,20200220,WA,628,1,629,0.998410175
3573,20200219,WA,628,1,629,0.998410175
3574,20200218,WA,628,1,629,0.998410175
3575,20200217,WA,628,1,629,0.998410175
3576,20200216,WA,628,1,629,0.998410175
3577,20200215,WA,628,1,629,0.998410175
3578,20200214,WA,628,1,629,0.998410175
3579,20200213,WA,628,1,629,0.998410175
3580,20200212,WA,628,1,629,0.998410175
3581,20200211,WA,628,1,629,0.998410175
3582,20200210,WA,628,1,629,0.998410175
3583,20200209,WA,628,1,629,0.998410175
3584,20200208,WA,628,1,629,0.998410175
3585,20200207,WA,628,1,629,0.998410175
3586,20200206,WA,3,1,4,0.75
3587,20200205,WA,3,1,4,0.75
3588,20200204,WA,3,1,4,0.75
3589,20200203,WA,3,1,4,0.75
3590,20200202,WA,3,1,4,0.75
3591,20200201,WA,3,1,4,0.75
3592,20200131,WA,3,1,4,0.75
3593,20200130,WA,3,1,4,0.75
3594,20200129,WA,3,1,4,0.75
3595,20200128,WA,3,1,4,0.75
3596,20200127,WA,3,1,4,0.75
3597,20200126,WA,3,1,4,0.75
3598,20200125,WA,3,1,4,0.75
3599,20200124,WA,3,1,4,0.75
3600,20200123,WA,3,1,4,0.75
3601,20200122,WA,3,1,4,0.75
54,20200508,WI,2155,2670,4825,0.446632124
110,20200507,WI,2139,2635,4774,0.448051948
166,20200506,WI,2067,2547,4614,0.447984395
222,20200505,WI,2049,2517,4566,0.448751643
278,20200504,WI,2035,2490,4525,0.449723757
334,20200503,WI,1964,2410,4374,0.449016918
390,20200502,WI,1944,2386,4330,0.448960739
446,20200501,WI,1929,2352,4281,0.450595655
502,20200430,WI,1820,2263,4083,0.445750674
558,20200429,WI,1797,2224,4021,0.446903755
614,20200428,WI,1781,2183,3964,0.449293643
670,20200427,WI,1762,2161,3923,0.449146062
726,20200426,WI,1663,2075,3738,0.444890316
782,20200425,WI,1638,2039,3677,0.445471852
838,20200424,WI,1608,1991,3599,0.446790775
894,20200423,WI,1573,1942,3515,0.447510669
950,20200422,WI,1447,1851,3298,0.438750758
1006,20200421,WI,1420,1817,3237,0.438677788
1062,20200420,WI,1408,1796,3204,0.439450687
1118,20200419,WI,1391,1772,3163,0.439772368
1174,20200418,WI,1375,1742,3117,0.441129291
1230,20200417,WI,1358,1710,3068,0.442633638
1286,20200416,WI,1176,1679,2855,0.411908932
1342,20200415,WI,1153,1589,2742,0.420495988
1398,20200414,WI,1133,1556,2689,0.421346225
1454,20200413,WI,1114,1525,2639,0.422129595
1510,20200412,WI,1100,1501,2601,0.422914264
1566,20200411,WI,1083,1471,2554,0.42404072
1622,20200410,WI,1061,1435,2496,0.425080128
1678,20200409,WI,796,1382,2178,0.365472911
1734,20200408,WI,773,1349,2122,0.364278982
1790,20200407,WI,743,1226,1969,0.377348908
1846,20200406,WI,719,1160,1879,0.382650346
1902,20200405,WI,685,1122,1807,0.37908135
1958,20200404,WI,657,1069,1726,0.380648899
2014,20200403,WI,261,1026,1287,0.202797203
2070,20200402,WI,214,937,1151,0.185925282
2126,20200401,WI,170,769,939,0.181043663
2182,20200331,WI,119,698,817,0.145654835
2238,20200330,WI,77,586,663,0.116138763
2294,20200329,WI,40,642,682,0.058651026
2350,20200328,WI,2215,560,2775,0.798198198
2406,20200327,WI,2097,408,2505,0.837125749
2462,20200326,WI,1971,248,2219,0.888237945
2518,20200325,WI,1749,123,1872,0.934294872
2574,20200324,WI,1533,2441,3974,0.385757423
2630,20200323,WI,1481,2277,3758,0.394092602
2686,20200322,WI,1333,2106,3439,0.387612678
2742,20200321,WI,1015,1646,2661,0.381435551
2798,20200320,WI,835,1304,2139,0.390369331
2854,20200319,WI,519,859,1378,0.376632801
2910,20200318,WI,329,79,408,0.806372549
2966,20200317,WI,1978,7,1985,0.996473552
3022,20200316,WI,1543,1933,3476,0.443901036
3073,20200315,WI,1256,1400,2656,0.472891566
3124,20200314,WI,605,686,1291,0.46862897
3175,20200313,WI,605,686,1291,0.46862897
3226,20200312,WI,2025,2519,4544,0.445642606
3276,20200311,WI,1049,1720,2769,0.378837125
3326,20200310,WI,628,1514,2142,0.29318394
3376,20200309,WI,3,1514,1517,0.001977587
3426,20200308,WI,3,1376,1379,0.002175489
3476,20200307,WI,3,1376,1379,0.002175489
3513,20200306,WI,3,1376,1379,0.002175489
3538,20200305,WI,3,793,796,0.003768844
3553,20200304,WI,3,793,796,0.003768844
55,20200508,WV,107,2060,2167,0.049377019
111,20200507,WV,101,2022,2123,0.047574187
167,20200506,WV,90,1989,2079,0.043290043
223,20200505,WV,83,1976,2059,0.040310831
279,20200504,WV,72,1952,2024,0.035573123
335,20200503,WV,68,1924,1992,0.034136546
391,20200502,WV,60,1819,1879,0.031931879
447,20200501,WV,47,1776,1823,0.025781679
503,20200430,WV,42,1730,1772,0.023702032
559,20200429,WV,35,1701,1736,0.02016129
615,20200428,WV,30,1701,1731,0.017331023
671,20200427,WV,22,1701,1723,0.012768427
727,20200426,WV,16,1564,1580,0.010126582
783,20200425,WV,9,1395,1404,0.006410256
839,20200424,WV,2214,1233,3447,0.64229765
895,20200423,WV,2207,1166,3373,0.654313667
951,20200422,WV,2194,1106,3300,0.664848485
1007,20200421,WV,2178,999,3177,0.685552408
1063,20200420,WV,2172,977,3149,0.689742775
1119,20200419,WV,2108,799,2907,0.725146199
1175,20200418,WV,2017,766,2783,0.724757456
1231,20200417,WV,2002,717,2719,0.73630011
1287,20200416,WV,1991,704,2695,0.73877551
1343,20200415,WV,1969,657,2626,0.749809596
1399,20200414,WV,1876,634,2510,0.747410359
1455,20200413,WV,1863,626,2489,0.748493371
1511,20200412,WV,1849,573,2422,0.763418662
1567,20200411,WV,1739,517,2256,0.770833333
1623,20200410,WV,1723,476,2199,0.783537972
1679,20200409,WV,1695,416,2111,0.802936997
1735,20200408,WV,1541,321,1862,0.827604726
1791,20200407,WV,1478,251,1729,0.854829381
1847,20200406,WV,1281,2583,3864,0.331521739
1903,20200405,WV,1251,2460,3711,0.337105901
1959,20200404,WV,1016,2299,3315,0.306485671
2015,20200403,WV,912,2099,3011,0.302889406
2071,20200402,WV,863,1877,2740,0.314963504
2127,20200401,WV,622,1632,2254,0.27595386
2183,20200331,WV,546,1343,1889,0.289041821
2239,20200330,WV,407,925,1332,0.305555556
2295,20200329,WV,361,904,1265,0.285375494
2351,20200328,WV,2205,875,3080,0.715909091
2407,20200327,WV,2006,98,2104,0.953422053
2463,20200326,WV,1682,5,1687,0.997036159
2519,20200325,WV,1336,2393,3729,0.358272995
2575,20200324,WV,813,2170,2983,0.272544418
2631,20200323,WV,525,1764,2289,0.229357798
2687,20200322,WV,371,1580,1951,0.190158893
2743,20200321,WV,334,1451,1785,0.187114846
2799,20200320,WV,1909,1014,2923,0.653096134
2855,20200319,WV,628,532,1160,0.54137931
2911,20200318,WV,3,368,371,0.008086253
2967,20200317,WV,2,2485,2487,0.000804182
3023,20200316,WV,2,2485,2487,0.000804182
3074,20200315,WV,2,1563,1565,0.001277955
3125,20200314,WV,2,1149,1151,0.001737619
3176,20200313,WV,2,688,690,0.002898551
3227,20200312,WV,2,2276,2278,0.000877963
3277,20200311,WV,2,1274,1276,0.001567398
3327,20200310,WV,2,842,844,0.002369668
3377,20200309,WV,2,842,844,0.002369668
3427,20200308,WV,2,842,844,0.002369668
3477,20200307,WV,2,842,844,0.002369668
3514,20200306,WV,2,3,5,0.4
56,20200508,WY,1871,241,2112,0.885890152
112,20200507,WY,1869,241,2110,0.885781991
168,20200506,WY,1841,241,2082,0.884245917
224,20200505,WY,1757,134,1891,0.929138022
280,20200504,WY,1750,2600,4350,0.402298851
336,20200503,WY,1740,2588,4328,0.402033272
392,20200502,WY,1732,2580,4312,0.401669759
448,20200501,WY,1724,2564,4288,0.402052239
504,20200430,WY,1715,2482,4197,0.408625208
560,20200429,WY,1704,2466,4170,0.408633094
616,20200428,WY,1335,2440,3775,0.353642384
672,20200427,WY,1320,2316,3636,0.363036304
728,20200426,WY,1306,2316,3622,0.360574268
784,20200425,WY,1284,2316,3600,0.356666667
840,20200424,WY,1284,2313,3597,0.356964137
896,20200423,WY,1252,2289,3541,0.353572437
952,20200422,WY,1249,2291,3540,0.352824859
1008,20200421,WY,1246,2291,3537,0.35227594
1064,20200420,WY,1229,2280,3509,0.350242234
1120,20200419,WY,1218,2141,3359,0.362607919
1176,20200418,WY,1215,2104,3319,0.366074119
1232,20200417,WY,1044,2100,3144,0.332061069
1288,20200416,WY,1044,2100,3144,0.332061069
1344,20200415,WY,1021,2091,3112,0.328084833
1400,20200414,WY,997,1900,2897,0.34414912
1456,20200413,WY,997,1900,2897,0.34414912
1512,20200412,WY,974,1875,2849,0.341874342
1568,20200411,WY,974,1875,2849,0.341874342
1624,20200410,WY,953,1653,2606,0.365694551
1680,20200409,WY,907,1337,2244,0.404188948
1736,20200408,WY,883,1335,2218,0.398106402
1792,20200407,WY,862,1332,2194,0.392889699
1848,20200406,WY,855,1325,2180,0.392201835
1904,20200405,WY,626,1279,1905,0.328608924
1960,20200404,WY,602,922,1524,0.395013123
2016,20200403,WY,546,903,1449,0.376811594
2072,20200402,WY,515,883,1398,0.368383405
2128,20200401,WY,442,864,1306,0.338437979
2184,20200331,WY,332,118,450,0.737777778
2240,20200330,WY,2195,106,2301,0.953933073
2296,20200329,WY,2106,77,2183,0.964727439
2352,20200328,WY,2085,70,2155,0.967517401
2408,20200327,WY,1965,31,1996,0.984468938
2464,20200326,WY,1699,9,1708,0.994730679
2520,20200325,WY,1508,2658,4166,0.361977916
2576,20200324,WY,1024,2344,3368,0.304038005
2632,20200323,WY,961,2086,3047,0.315392189
2688,20200322,WY,914,1745,2659,0.343738247
2744,20200321,WY,892,1745,2637,0.338263178
2800,20200320,WY,605,1452,2057,0.294117647
2856,20200319,WY,577,1206,1783,0.32361189
2912,20200318,WY,490,735,1225,0.4
2968,20200317,WY,283,2650,2933,0.096488237
3024,20200316,WY,1049,1,1050,0.999047619
3075,20200315,WY,1049,1,1050,0.999047619
3126,20200314,WY,628,1,629,0.998410175
3177,20200313,WY,3,1,4,0.75
3228,20200312,WY,3,1,4,0.75
3278,20200311,WY,2,1,3,0.666666667
3328,20200310,WY,2,2,4,0.5
3378,20200309,WY,2,1,3,0.666666667
3428,20200308,WY,2,1,3,0.666666667
3478,20200307,WY,2,1,3,0.666666667